Lake,Month,Date,Year,Buffalo,Drum,Carp,Total Rough Fish
Center Lake,February,2/20/1991,1991,250,170,17300,17720
Center Lake,April,4/20/1996,1996,1400,0,1500,2900
Center Lake,April,4/21/1996,1996,0,0,0,0
Center Lake,October,10/21/1996,1996,800,400,1400,2600
Center Lake,April,4/17/1997,1997,0,0,299,299
Center Lake,April,4/29/1997,1997,0,0,220,220
Center Lake,May,5/6/1997,1997,400,0,17111,17511
Center Lake,June,6/2/1997,1997,478,0,4466,4944
Center Lake,April,4/23/1998,1998,1450,275,2817,4542
Center Lake,April,4/24/1998,1998,0,0,0,0
Center Lake,May,5/5/1998,1998,0,0,2200,2200
Center Lake,November,11/14/1998,1998,1100,0,3200,4300
Center Lake,November,11/20/1998,1998,1350,100,34200,35650
Center Lake,February,2/4/1999,1999,40,0,447,487
Center Lake,April,4/9/1999,1999,30,7,10,47
Center Lake,may,5/22/2001,2001,1000,50,6200,7250
Center Lake,may,5/13/2010,2010,4450,700,28000,33150
Center Lake,may,5/24/2010,2010,2600,700,4100,7400
Center Lake,May,5/10/2011,2011,3500,1400,10750,15650
Center Lake,April,4/2/2012,2012,4200,450,16800,21450
Center Lake,April,4/5/2012,2012,6900,1900,4600,13400
Center Lake,April,4/25/2013,2013,24800,2430,16750,43980
Center Lake,May,5/14/2013,2013,950,200,280,1430
Center Lake,April,4/23/2014,2014,4800,900,5900,11600
Center Lake,April,4/24/2014,2014,12400,1100,2800,16300
Center Lake,April,4/14/2015,2015,4200,250,5500,9950
Center Lake,April,4/15/2015,2015,19200,300,11500,31000
Center Lake,May,5/3/2016,2016,150,50,350,550
Center Lake,May,5/18/2016,2016,58700,100,1900,60700
Center Lake,May,5/20/2016,2016,13100,0,450,13550
Center Lake,June,6/3/2016,2016,400,0,1100,1500
Center Lake,April,4/26/2017,2017,14200,200,1300,15700
Center Lake,April,4/27/2017,2017,6200,100,4400,10700
Center Lake,May,5/11/2017,2011,16800,6900,4550,28250
Center Lake,May,5/17/2017,2017,10700,50,3700,14450
Diamond Lake,May,5/8/2001,2001,2400,0,1000,3400
East Okoboji Lake,February,2/15/1984,1984,56,11750,625,12431
East Okoboji Lake,April,4/12/1989,1989,1200,200,37500,38900
East Okoboji Lake,April,4/13/1989,1989,1100,1400,41750,44250
East Okoboji Lake,April,4/25/1989,1989,0,1500,31200,32700
East Okoboji Lake,April,4/28/1989,1989,600,450,3500,4550
East Okoboji Lake,May,5/2/1989,1989,350,200,9200,9750
East Okoboji Lake,May,5/10/1989,1989,6200,3400,2750,12350
East Okoboji Lake,May,5/16/1989,1989,700,0,3800,4500
East Okoboji Lake,May,5/23/1989,1989,0,0,900,900
East Okoboji Lake,May,5/30/1989,1989,0,0,0,0
East Okoboji Lake,October,10/12/1989,1989,0,174,1236,1410
East Okoboji Lake,October,10/13/1989,1989,0,389,888,1277
East Okoboji Lake,November,11/1/1989,1989,0,45,0,45
East Okoboji Lake,April,4/12/1990,1990,0,0,10380,10380
East Okoboji Lake,April,4/14/1990,1990,0,94,10125,10219
East Okoboji Lake,April,4/18/1990,1990,0,60,480,540
East Okoboji Lake,May,5/19/1990,1990,270,550,1875,2695
East Okoboji Lake,May,5/20/1990,1990,200,450,5125,5775
East Okoboji Lake,May,5/21/1990,1990,550,270,7000,7820
East Okoboji Lake,May,5/22/1990,1990,1050,500,7500,9050
East Okoboji Lake,May,5/23/1990,1990,1100,390,8900,10390
East Okoboji Lake,May,5/24/1990,1990,400,0,3100,3500
East Okoboji Lake,May,5/26/1992,1992,0,414,80,494
East Okoboji Lake,May,5/3/1993,1993,650,250,860,1760
East Okoboji Lake,May,5/3/1994,1994,800,100,3600,4500
East Okoboji Lake,May,5/12/1994,1994,650,100,2900,3650
East Okoboji Lake,May,5/14/1994,1994,450,250,2250,2950
East Okoboji Lake,May,5/20/1994,1994,850,250,7200,8300
East Okoboji Lake,May,5/21/1994,1994,900,300,4400,5600
East Okoboji Lake,May,5/24/1994,1994,1200,300,6850,8350
East Okoboji Lake,May,5/20/1995,1995,100,100,3800,4000
East Okoboji Lake,May,5/25/1995,1995,500,250,7600,8350
East Okoboji Lake,May,5/11/1996,1996,1100,5700,17200,24000
East Okoboji Lake,May,5/20/1996,1996,3100,5400,23200,31700
East Okoboji Lake,May,5/31/1996,1996,2700,3600,9300,15600
East Okoboji Lake,June,6/10/1996,1996,1800,1700,8600,12100
East Okoboji Lake,October,10/25/1996,1996,0,1200,50,1250
East Okoboji Lake,February,2/19/1997,1997,0,0,3200,3200
East Okoboji Lake,February,2/27/1997,1997,10500,0,37900,48400
East Okoboji Lake,March,3/3/1997,1997,22900,4800,123500,151200
East Okoboji Lake,March,3/5/1997,1997,200,4200,6050,10450
East Okoboji Lake,March,3/6/1997,1997,2100,4300,10400,16800
East Okoboji Lake,March,3/7/1997,1997,1800,100,17900,19800
East Okoboji Lake,April,4/16/1997,1997,900,1100,8400,10400
East Okoboji Lake,May,5/6/1997,1997,6625,5140,23160,34925
East Okoboji Lake,May,5/19/1997,1997,1550,920,8940,11410
East Okoboji Lake,June,6/11/1997,1997,650,400,5600,6650
East Okoboji Lake,February,2/4/1998,1998,4500,2100,129200,135800
East Okoboji Lake,February,2/5/1998,1998,75,240,2900,3215
East Okoboji Lake,April,4/28/1998,1998,150,896,305,1351
East Okoboji Lake,May,5/20/1998,1998,700,650,3100,4450
East Okoboji Lake,May,5/5/1999,1999,200,600,1600,2400
East Okoboji Lake,May,5/6/1999,1999,5800,2200,17600,25600
East Okoboji Lake,May,5/21/1999,1999,400,0,7200,7600
East Okoboji Lake,May,5/25/1999,1999,100,550,1200,1850
East Okoboji Lake,November,11/12/1999,1999,0,40,150,190
East Okoboji Lake,November,11/15/1999,1999,250,20,200,470
East Okoboji Lake,November,11/16/1999,1999,700,350,11300,12350
East Okoboji Lake,November,11/17/1999,1999,1860,750,8700,11310
East Okoboji Lake,April,4/24/2000,2000,200,30,650,880
East Okoboji Lake,April,4/25/2000,2000,1100,100,2700,3900
East Okoboji Lake,April,4/26/2000,2000,13500,10000,52500,76000
East Okoboji Lake,May,5/1/2000,2000,16600,6200,43900,66700
East Okoboji Lake,May,5/4/2000,2000,3300,2900,14500,20700
East Okoboji Lake,May,5/9/2000,2000,1900,2500,4300,8700
East Okoboji Lake,May,5/11/2000,2000,200,3550,4250,8000
East Okoboji Lake,May,5/15/2000,2000,100,1250,2350,3700
East Okoboji Lake,May,5/24/2000,2000,820,3550,14700,19070
East Okoboji Lake,april,4/17/2001,2001,10550,14500,15300,40350
East Okoboji Lake,april,4/18/2001,2001,4075,300,14000,18375
East Okoboji Lake,april,4/20/2001,2001,5050,0,1400,6450
East Okoboji Lake,April,4/23/2001,2001,3500,8000,6300,17800
East Okoboji Lake,April,4/24/2001,2001,5025,4500,1500,11025
East Okoboji Lake,april,4/26/2001,2001,5000,2000,5000,12000
East Okoboji Lake,april,4/29/2001,2001,2250,1500,1500,5250
East Okoboji Lake,may,5/2/2001,2001,600,300,3000,3900
East Okoboji Lake,may,5/4/2001,2001,2350,100,4500,6950
East Okoboji Lake,may,5/9/2001,2001,1000,1000,5000,7000
East Okoboji Lake,may,5/10/2001,2001,1800,0,300,2100
East Okoboji Lake,may,5/16/2001,2001,6100,3000,2800,11900
East Okoboji Lake,may,5/17/2001,2001,750,0,8000,8750
East Okoboji Lake,may,5/18/2001,2001,900,500,900,2300
East Okoboji Lake,may,5/21/2001,2001,100,300,1400,1800
East Okoboji Lake,may,5/29/2001,2001,2500,0,4000,6500
East Okoboji Lake,May,5/30/2001,2001,0,700,2300,3000
East Okoboji Lake,june,6/1/2001,2001,200,50,50,300
East Okoboji Lake,February,2/13/2002,2002,6100,893,49030,56023
East Okoboji Lake,February,2/14/2002,2002,13450,5354,53465,72269
East Okoboji Lake,april,4/15/2002,2002,23600,9300,15500,48400
East Okoboji Lake,april,4/17/2002,2002,3500,550,8200,12250
East Okoboji Lake,april,4/22/2002,2002,700,1700,4500,6900
East Okoboji Lake,april,4/30/2002,2002,200,100,1200,1500
East Okoboji Lake,may,5/6/2002,2002,17400,1200,14750,33350
East Okoboji Lake,may,5/16/2002,2002,3200,2400,6100,11700
East Okoboji Lake,may,5/30/2002,2002,2700,1600,1350,5650
East Okoboji Lake,april,4/22/2003,2003,1100,800,6400,8300
East Okoboji Lake,april,4/28/2003,2003,14600,0,22900,37500
East Okoboji Lake,may,5/5/2003,2003,3000,850,13400,17250
East Okoboji Lake,may,5/14/2003,2003,4400,500,1150,6050
East Okoboji Lake,april,4/26/2004,2004,4200,2000,6100,12300
East Okoboji Lake,may,5/4/2004,2004,1200,5500,800,7500
East Okoboji Lake,may,5/5/2004,2004,9200,1200,9600,20000
East Okoboji Lake,may,5/10/2004,2004,1800,4200,6000,12000
East Okoboji Lake,may,5/11/2004,2004,7600,9500,2400,19500
East Okoboji Lake,april,4/21/2005,2005,9400,4500,15500,29400
East Okoboji Lake,april,4/26/2005,2005,1500,4700,45500,51700
East Okoboji Lake,may,5/3/2005,2005,1250,4600,12300,18150
East Okoboji Lake,may,5/16/2005,2005,1900,15200,6600,23700
East Okoboji Lake,april,4/11/2006,2006,3800,12200,11400,27400
East Okoboji Lake,april,4/12/2006,2006,16100,14000,2800,32900
East Okoboji Lake,april,4/18/2006,2006,2600,18500,3500,24600
East Okoboji Lake,april,4/25/2006,2006,800,4800,2400,8000
East Okoboji Lake,may,5/4/2006,2006,2100,5800,2800,10700
East Okoboji Lake,may,5/9/2006,2006,2200,9500,16400,28100
East Okoboji Lake,may,5/16/2006,2006,2200,11500,7600,21300
East Okoboji Lake,may,5/30/2006,2006,2700,0,6600,9300
East Okoboji Lake,may,5/31/2006,2006,800,9800,11200,21800
East Okoboji Lake,june,6/8/2006,2006,850,0,1900,2750
East Okoboji Lake,april,4/19/2007,2007,41200,8100,18500,67800
East Okoboji Lake,april,4/23/2007,2007,9200,6700,5500,21400
East Okoboji Lake,april,4/24/2007,2007,36500,7500,18400,62400
East Okoboji Lake,april,4/26/2007,2007,2400,6500,13000,21900
East Okoboji Lake,april,4/30/2007,2007,37300,9700,11800,58800
East Okoboji Lake,may,5/3/2007,2007,17900,4600,12700,35200
East Okoboji Lake,may,5/8/2007,2007,16300,7500,16300,40100
East Okoboji Lake,may,5/9/2007,2007,3500,9500,17200,30200
East Okoboji Lake,april,4/21/2008,2008,6100,18400,900,25400
East Okoboji Lake,april,4/22/2008,2008,800,2100,17200,20100
East Okoboji Lake,april,4/23/2008,2008,4300,3600,28000,35900
East Okoboji Lake,april,4/29/2008,2008,800,1700,22000,24500
East Okoboji Lake,april,4/30/2008,2008,100,50,200,350
East Okoboji Lake,may,5/6/2008,2008,4800,5100,500,10400
East Okoboji Lake,may,5/7/2008,2008,1200,5400,900,7500
East Okoboji Lake,may,5/14/2008,2008,50,100,600,750
East Okoboji Lake,may,5/22/2008,2008,3200,1600,400,5200
East Okoboji Lake,march,3/3/2009,2009,7200,14100,12900,34200
East Okoboji Lake,march,3/4/2009,2009,6400,16400,31700,54500
East Okoboji Lake,april,4/14/2009,2009,7200,6300,12500,26000
East Okoboji Lake,april,4/23/2009,2009,1500,900,16400,18800
East Okoboji Lake,may,5/12/2009,2009,11400,5800,1500,18700
East Okoboji Lake,april,4/20/2010,2010,19700,9500,4100,33300
East Okoboji Lake,april,4/27/2010,2010,200,9800,700,10700
East Okoboji Lake,may,5/4/2010,2010,10800,8500,2300,21600
East Okoboji Lake,may,5/19/2010,2010,10400,9700,300,20400
East Okoboji Lake,April,4/29/2011,2011,11000,5200,11300,27500
East Okoboji Lake,May,5/5/2011,2011,400,5300,800,6500
East Okoboji Lake,May,5/16/2011,2011,250,1600,200,2050
East Okoboji Lake,March,3/29/2012,2012,5700,1700,8600,16000
East Okoboji Lake,April,4/4/2012,2012,5200,1800,15900,22900
East Okoboji Lake,April,4/19/2012,2012,4400,0,2500,6900
East Okoboji Lake,April,4/23/2012,2012,900,1100,2800,4800
East Okoboji Lake,May,5/16/2013,2013,48200,6750,17100,72050
East Okoboji Lake,May,5/20/2013,2013,52600,6950,10800,70350
East Okoboji Lake,May,5/5/2014,2014,14600,4500,12200,31300
East Okoboji Lake,May,5/8/2014,2014,16200,18900,4400,39500
East Okoboji Lake,May,5/12/2014,2014,500,12100,1300,13900
East Okoboji Lake,May,5/14/2014,2014,28800,7700,18100,54600
East Okoboji Lake,May,5/21/2014,2014,24800,14300,12200,51300
East Okoboji Lake,May,5/27/2014,2014,2100,3900,1200,7200
East Okoboji Lake,April,4/27/2015,2015,13100,250,350,13700
East Okoboji Lake,April,4/30/2015,2015,2500,150,9100,11750
East Okoboji Lake,May,5/4/2015,2015,1700,0,300,2000
East Okoboji Lake,April,4/19/2016,2016,3100,400,6200,9700
Elk Lake,October,10/30/1995,1995,0,0,1900,1900
Elk Lake,April,4/15/1997,1997,3200,0,3300,6500
Elk Lake,April,4/17/1997,1997,10700,0,5700,16400
Elk Lake,October,10/20/1997,1997,5000,0,1150,6150
Elk Lake,October,10/21/1997,1997,1900,0,3236,5136
Elk Lake,October,10/22/1997,1997,3000,0,2850,5850
Elk Lake,April,4/14/1998,1998,2850,0,2900,5750
Elk Lake,April,4/15/1998,1998,530,0,600,1130
Elk Lake,November,11/3/1998,1998,1350,0,1400,2750
Elk Lake,May,5/20/1999,1999,350,50,4100,4500
Elk Lake,October,10/20/2000,2000,500,25,3000,3525
elk lake,october,10/14/2003,2003,3600,150,4400,8150
elk lake,September,9/8/2006,2006,15110,105,1075,16290
elk lake,october,10/31/2006,2006,1425,0,2800,4225
elk lake,november,11/1/2006,2006,21700,0,3915,25615
elk lake,September,9/15/2007,2007,11900,0,1110,13010
elk lake,September,9/16/2007,2007,3200,0,785,3985
elk lake,october,10/1/2007,2007,3810,0,2275,6085
elk lake,September,9/3/2008,2008,3195,0,900,4095
elk lake,September,9/4/2008,2008,11530,0,795,12325
elk lake,october,10/4/2009,2009,3785,0,1200,4985
Elk lake,September,9/20/2010,2010,450,0,2175,2625
elk lake,october,10/8/2010,2010,9300,0,120,9420
Elk lake,September,9/18/2011,2011,9250,0,1180,10430
Elk lake,September,9/19/2011,2011,1140,0,570,1710
Elk lake,October,10/11/2014,2014,11900,8,860,12768
Elk lake,October,10/12/2014,2014,5640,8,1280,6928
Elk lake,October,10/18/2015,2015,4900,18,1986,6904
Elk lake,October,10/19/2015,2015,900,9,310,1219
Elk lake,October,10/29/2016,2016,5675,0,650,6325
Elk lake,October,10/30/2016,2016,2410,4,260,2674
Elk lake,October,10/28/2017,2017,12719,70,3200,15989
Elk lake,October,10/29/2017,2017,1928,10,3682,5620
Five Island Lake,September,9/29/1987,1987,72,0,3400,3472
Five Island Lake,September,9/30/1987,1987,200,0,600,800
Five Island Lake,September,9/30/1987,1987,170,0,3500,3670
Five Island Lake,October,10/1/1987,1987,6000,0,250,6250
Five Island Lake,October,10/5/1987,1987,230,0,3400,3630
Five Island Lake,October,10/6/1987,1987,3785,0,840,4625
Five Island Lake,October,10/7/1987,1987,9450,0,10000,19450
Five Island Lake,October,10/19/1987,1987,3490,0,28600,32090
Five Island Lake,October,10/20/1987,1987,240,0,2700,2940
Five Island Lake,October,10/21/1987,1987,370,0,8100,8470
Five Island Lake,November,11/4/1987,1987,200,0,1500,1700
Five Island Lake,November,11/18/1987,1987,250,0,31480,31730
Five Island Lake,September,9/19/1988,1988,4600,0,8820,13420
Five Island Lake,September,9/20/1988,1988,17000,0,13800,30800
Five Island Lake,September,9/21/1988,1988,730,0,6600,7330
Five Island Lake,October,10/25/1988,1988,65,0,800,865
Five Island Lake,October,10/26/1988,1988,3255,0,11285,14540
Five Island Lake,October,10/27/1988,1988,405,0,8100,8505
Five Island Lake,November,11/1/1988,1988,3465,0,21185,24650
Five Island Lake,November,11/2/1988,1988,17020,0,14540,31560
Five Island Lake,November,11/5/1988,1988,210,0,10710,10920
Five Island Lake,November,11/7/1988,1988,210,0,21945,22155
Five Island Lake,November,11/8/1988,1988,17665,0,30765,48430
Five Island Lake,October,10/3/1989,1989,14250,0,50,14300
Five Island Lake,October,10/4/1989,1989,15,0,52,67
Five Island Lake,October,10/5/1989,1989,50,0,4500,4550
Five Island Lake,October,10/9/1989,1989,70,0,9500,9570
Five Island Lake,November,11/2/1989,1989,2020,0,47000,49020
Five Island Lake,November,11/3/1989,1989,25,0,17000,17025
Five Island Lake,September,9/19/1990,1990,150,0,22100,22250
Five Island Lake,September,9/20/1990,1990,8000,0,100,8100
Five Island Lake,October,10/20/1990,1990,2400,0,650,3050
Five Island Lake,October,10/22/1990,1990,1800,0,450,2250
Five Island Lake,November,11/3/1990,1990,15,0,500,515
Five Island Lake,November,11/3/1990,1990,30,0,900,930
Five Island Lake,September,9/23/1991,1991,784,0,7292,8076
Five Island Lake,September,9/24/1991,1991,1600,0,100,1700
Five Island Lake,September,9/25/1991,1991,16,0,8,24
Five Island Lake,September,9/26/1991,1991,2500,0,8600,11100
Five Island Lake,October,10/8/1991,1991,400,0,0,400
Five Island Lake,October,10/9/1991,1991,400,0,18,418
Five Island Lake,October,10/9/1991,1991,4600,0,50,4650
Five Island Lake,October,10/10/1991,1991,2100,0,2800,4900
Five Island Lake,October,10/11/1991,1991,1800,0,3632,5432
Five Island Lake,October,10/26/1998,1998,50,0,1200,1250
Five Island Lake,October,10/27/1998,1998,3300,0,10600,13900
Five Island Lake,October,10/28/1998,1998,1500,0,1900,3400
Five Island Lake,October,10/29/1998,1998,600,0,2500,3100
Five Island Lake,October,10/30/1998,1998,4600,0,1400,6000
Five Island Lake,November,11/1/1998,1998,1200,0,16400,17600
Five Island Lake,November,11/5/1998,1998,1350,0,9200,10550
Five Island Lake,November,11/6/1998,1998,2800,0,11000,13800
Five Island Lake,November,11/7/1998,1998,800,0,200,1000
Five Island Lake,November,11/8/1998,1998,600,0,1200,1800
Five Island Lake,November,11/9/1998,1998,0,0,0,0
Five Island Lake,November,11/12/1998,1998,900,0,200,1100
Five Island Lake,November,11/13/1998,1998,400,0,9200,9600
Five Island Lake,June,6/3/1999,1999,400,0,2900,3300
Five Island Lake,October,10/21/1999,1999,5000,0,250,5250
Five Island Lake,October,10/22/1999,1999,2600,0,1500,4100
Five Island Lake,October,10/26/1999,1999,4200,0,3600,7800
Five Island Lake,October,10/27/1999,1999,740,0,600,1340
Five Island Lake,October,10/28/1999,1999,850,0,1600,2450
Five Island Lake,October,10/29/1999,1999,5200,0,8500,13700
Five Island Lake,November,11/9/1999,1999,1500,0,3800,5300
Five Island Lake,March,3/20/2000,2000,1300,100,4100,5500
Five Island Lake,March,3/21/2000,2000,3250,50,12400,15700
Five Island Lake,March,3/22/2000,2000,5300,150,1100,6550
Five Island Lake,March,3/24/2000,2000,500,50,2000,2550
Five Island Lake,March,3/29/2000,2000,1300,50,1800,3150
Five Island Lake,March,3/30/2000,2000,2550,100,1300,3950
Five Island Lake,April,Apr-00,2000,200,30,2000,2230
Five Island Lake,April,4/13/2000,2000,5200,200,5000,10400
Five Island Lake,April,4/14/2000,2000,50,0,100,150
Five Island Lake,April,4/17/2000,2000,500,50,2400,2950
Five Island Lake,May,5/25/2000,2000,11800,50,17050,28900
Five Island Lake,September,9/8/2000,2000,12200,0,450,12650
Five Island Lake,September,9/11/2000,2000,4550,0,0,4550
Five Island Lake,October,10/11/2000,2000,4700,0,1450,6150
Five Island Lake,October,10/18/2000,2000,250,0,300,550
Five Island Lake,October,10/19/2000,2000,1150,0,850,2000
Five Island Lake,October,10/20/2000,2000,8550,0,1600,10150
Five Island Lake,October,10/25/2000,2000,1600,0,2900,4500
Five Island Lake,October,10/26/2000,2000,1400,0,300,1700
Five Island Lake,October,10/27/2000,2000,21000,0,600,21600
Five Island Lake,May,5/1/2001,2001,5400,0,2200,7600
Five Island Lake,May,5/2/2001,2001,2200,0,900,3100
Five Island Lake,May,5/3/2001,2001,5900,0,700,6600
Five Island Lake,May,5/8/2001,2001,2700,0,200,2900
Five Island Lake,May,5/9/2001,2001,4700,0,600,5300
Five Island Lake,may,5/11/2001,2001,5200,0,300,5500
Five Island Lake,may,5/14/2001,2001,2050,0,200,2250
Five Island Lake,may,5/23/2001,2001,3650,0,450,4100
Five Island Lake,may,5/29/2001,2001,2100,0,400,2500
Five Island Lake,September,9/25/2001,2001,11200,0,1450,12650
Five Island Lake,September,9/27/2001,2001,500,0,1600,2100
Five Island Lake,October,10/1/2001,2001,6100,0,1100,7200
Five Island Lake,October,10/2/2001,2001,1500,0,200,1700
Five Island Lake,October,10/4/2001,2001,400,0,100,500
Five Island Lake,October,10/11/2001,2001,3100,0,800,3900
Five Island Lake,October,10/16/2001,2001,300,0,200,500
Five Island Lake,May,5/10/2002,2002,940,0,200,1140
Five Island Lake,may,5/20/2002,2002,900,0,400,1300
Five Island Lake,October,10/1/2002,2002,2650,0,1300,3950
Five Island Lake,October,10/7/2002,2002,950,0,12100,13050
Five Island Lake,October,10/8/2002,2002,550,0,4300,4850
Five Island Lake,april,4/29/2003,2003,13402,0,15300,28702
Five Island Lake,april,4/30/2003,2003,5000,0,5000,10000
Five Island Lake,september,9/10/2003,2003,810,0,150,960
Five Island Lake,september,9/15/2003,2003,100,0,1500,1600
Five Island Lake,april,4/7/2004,2004,54360,0,4850,59210
Five Island Lake,may,5/18/2004,2004,1400,0,4290,5690
Five Island Lake,may,5/19/2004,2004,100,0,10700,10800
Five Island Lake,September,9/22/2004,2004,2217,0,3017,5234
Five Island Lake,april,4/14/2005,2005,1450,0,300,1750
Five Island Lake,april,4/18/2005,2005,1600,0,8000,9600
Five Island Lake,april,4/19/2005,2005,1050,0,5000,6050
Five Island Lake,may,5/16/2005,2005,350,0,2200,2550
Five Island Lake,may,5/17/2005,2005,275,0,3100,3375
Five Island Lake,may,5/18/2005,2005,625,0,3900,4525
Five Island Lake,may,5/19/2005,2005,975,0,5000,5975
Five Island Lake,may,5/20/2005,2005,700,0,2400,3100
Five Island Lake,October,10/24/2005,2005,710,0,370,1080
Five Island Lake,October,10/25/2005,2005,540,0,680,1220
Five Island Lake,October,10/27/2005,2005,640,0,250,890
Five Island Lake,October,10/28/2005,2005,790,0,1750,2540
Five Island Lake,may,5/3/2006,2006,800,0,150,950
Five Island Lake,may,5/8/2006,2006,1000,0,12000,13000
Five Island Lake,may,5/11/2006,2006,1500,0,8500,10000
Five Island Lake,april,4/17/2007,2007,12965,0,5700,18665
Five Island Lake,april,4/18/2007,2007,200,0,1865,2065
Five Island Lake,april,4/19/2007,2007,900,0,6400,7300
Five Island Lake,april,4/20/2007,2007,1335,0,115,1450
Five Island Lake,September,9/28/2007,2007,0,0,440,440
Five Island Lake,april,4/21/2008,2008,2800,0,765,3565
Five Island Lake,april,4/22/2008,2008,43700,0,2150,45850
Five Island Lake,april,4/29/2008,2008,1100,0,1950,3050
Five Island Lake,october,10/29/2008,2008,6200,0,1150,7350
Five Island Lake,october,10/30/2008,2008,7100,0,105,7205
Five Island Lake,April,4/24/2009,2009,20110,0,495,20605
Five Island Lake,September,9/8/2009,2009,18202,0,327,18529
Five Island Lake,September,9/18/2009,2009,26820,0,1050,27870
Five Island Lake,September,9/19/2009,2009,4120,0,2000,6120
Five Island Lake,october,10/5/2009,2009,850,0,525,1375
Five Island Lake,october,10/6/2009,2009,12240,0,85,12325
Five Island Lake,April,4/24/2012,2012,21000,0,24000,45000
Five Island Lake,April,4/25/2012,2012,6400,0,57000,63400
Five Island Lake,May,5/6/2013,2013,12600,50,17100,29750
Five Island Lake,May,5/7/2013,2013,10600,0,17900,28500
Five Island Lake,May,5/13/2013,2013,2800,0,24600,27400
Five Island Lake,May,5/6/2014,2014,300,0,2400,2700
Five Island Lake,April,4/22/2015,2015,6100,0,800,6900
Five Island Lake,April,4/23/2015,2015,1100,0,400,1500
Five Island Lake,May,5/13/2015,2015,2200,0,6100,8300
Five Island Lake,May,5/14/2015,2015,4100,0,11300,15400
Five Island Lake,May,5/18/2015,2015,7200,0,4100,11300
Five Island Lake,May,5/20/2015,2015,100,0,5100,5200
Five Island Lake,May,5/26/2015,2015,1100,0,400,1500
Five Island Lake,May,5/27/2015,2015,1600,0,200,1800
Five Island Lake,October,10/25/2015,2015,19200,0,1000,20200
Five Island Lake,May,5/5/2016,2016,26700,0,6900,33600
Five Island Lake,May,5/6/2016,2016,31200,0,13600,44800
Five Island Lake,May,5/12/2016,2016,10900,0,12400,23300
Five Island Lake,May,5/17/2016,2016,13200,0,2700,15900
Five Island Lake,May,5/22/2016,2016,16800,100,1900,18800
Five Island Lake,May,5/2/2017,2017,7400,0,2200,9600
Five Island Lake,May,5/9/2017,2017,21300,0,10100,31400
Five Island Lake,May,5/11/2017,2017,10200,0,14700,24900
Five Island Lake,May,5/12/2017,2017,5300,0,11800,17100
High Lake,October,10/1/1990,1990,0,0,11340,11340
High Lake,October,10/2/1990,1990,19000,0,315,19315
High Lake,October,10/9/1990,1990,12500,0,27000,39500
High Lake,October,10/10/1990,1990,2800,0,13500,16300
High Lake,October,10/12/1990,1990,9900,0,8400,18300
High Lake,October,10/21/1990,1990,4400,0,18400,22800
High Lake,November,11/1/1990,1990,4500,0,6475,10975
High Lake,November,11/2/1990,1990,2200,0,8400,10600
High Lake,November,11/4/1990,1990,1655,0,26320,27975
High Lake,September,9/30/1991,1991,4900,0,600,5500
High Lake,October,10/1/1991,1991,1200,0,1400,2600
High Lake,October,10/2/1991,1991,800,0,5200,6000
High Lake,October,10/3/1991,1991,900,0,2000,2900
High Lake,October,10/29/1991,1991,50,0,2400,2450
High Lake,October,10/30/1991,1991,800,0,800,1600
High Lake,October,10/31/1991,1991,1300,0,6100,7400
High Lake,September,9/21/1992,1992,2700,0,900,3600
High Lake,September,9/22/1992,1992,15700,0,700,16400
High Lake,October,10/21/1992,1992,1100,0,200,1300
High Lake,October,10/22/1992,1992,1200,0,800,2000
High Lake,November,11/19/1992,1992,5100,0,3800,8900
High Lake,November,11/20/1992,1992,5600,0,18300,23900
High Lake,September,9/15/1993,1993,1486,0,3100,4586
High Lake,September,9/30/1993,1993,35,0,300,335
High Lake,November,11/2/1993,1993,1600,0,5800,7400
High Lake,November,11/3/1993,1993,1300,0,3000,4300
High Lake,November,11/17/1993,1993,2900,0,800,3700
High Lake,April,4/3/1995,1995,810,0,0,1180
High Lake,September,9/28/1995,1995,200,0,5200,5400
High Lake,October,10/5/1995,1995,200,0,300,500
High Lake,October,10/31/1996,1996,1900,0,13600,15500
High Lake,November,11/1/1996,1996,17100,0,132095,149195
High Lake,October,10/30/1997,1997,1900,0,750,2650
High Lake,November,11/5/1997,1997,7250,0,33900,41150
High Lake,September,9/23/1998,1998,1350,0,3000,4350
High Lake,September,9/24/1998,1998,33070,0,13100,46170
High Lake,November,11/13/1998,1998,1200,0,564,1764
High Lake,September,9/21/1999,1999,1300,0,7100,8400
High Lake,November,11/30/1999,1999,4960,0,8100,13060
High Lake,September,9/19/2000,2000,9592,0,8560,18152
High Lake,November,11/6/2000,2000,8290,0,12600,20890
High Lake,october,10/29/2003,2003,15400,0,450,15850
High Lake,October,10/26/2004,2004,30,0,20,50
High Lake,October,10/27/2004,2004,110,0,30,140
High Lake,October,10/5/2005,2005,6600,0,12400,19000
High Lake,October,10/6/2005,2005,700,0,7500,8200
High Lake,October,10/17/2005,2005,400,0,4945,5345
High Lake,October,10/18/2005,2005,95,0,570,665
High Lake,november,11/7/2005,2005,1950,0,1200,3150
High Lake,may,5/18/2006,2006,3000,0,4500,7500
High Lake,September,9/27/2006,2006,5400,0,7000,12400
High Lake,april,4/16/2007,2007,36000,0,17000,53000
High Lake,april,4/15/2009,2009,15200,0,55600,70800
High Lake,april,4/21/2009,2009,14100,0,27900,42000
High Lake,april,4/29/2009,2009,5600,0,18200,23800
High Lake,May,5/19/2011,2011,1800,0,4600,6400
High Lake,April,4/10/2012,2012,6000,0,37600,43600
High Lake,April,4/12/2012,2012,3200,0,17600,20800
High Lake,April,4/16/2013,2013,10500,0,1800,12300
High Lake,May,5/13/2013,2013,13000,0,950,13950
High Lake,May,5/13/2013,2013,13000,0,950,13950
High Lake,May,5/15/2013,2013,3000,0,300,3300
High Lake,September,9/24/2013,2013,20000,0,0,20000
High Lake,October,10/7/2013,2013,25000,0,150,25150
High Lake,October,10/14/2013,2013,350,0,50,400
High Lake,October,10/15/2013,2013,3950,0,850,4800
High Lake,September,9/11/2015,2015,14975,0,11470,26445
High Lake,September,9/12/2015,2015,13200,0,3200,16400
High Lake,October,10/4/2015,2015,7050,0,2830,9880
High Lake,May,5/9/2016,2016,2667,30000,334,33001
High Lake,May,5/10/2016,2016,2667,30000,334,33001
High Lake,May,5/11/2016,2016,2667,30000,334,33001
High Lake,September,9/12/2016,2016,3000,0,21000,24000
High Lake,September,9/14/2016,2016,3000,0,21000,24000
Ingham Lake,January,1/12/1989,1989,300,0,22300,22600
Ingham Lake,April,4/13/1989,1989,0,0,1200,1200
Ingham Lake,April,4/14/1992,1992,275,0,50,325
Ingham Lake,April,4/27/1992,1992,2050,0,2000,4050
Ingham Lake,April,4/30/1992,1992,30,0,25,55
Ingham Lake,April,4/30/1992,1992,225,0,200,425
Ingham Lake,September,9/30/1992,1992,100,0,200,300
Ingham Lake,October,10/1/1992,1992,550,0,300,850
Ingham Lake,October,10/3/1992,1992,3500,0,1000,4500
Ingham Lake,October,10/5/1992,1992,1000,0,300,1300
Ingham Lake,October,10/3/1994,1994,6900,0,300,7200
Ingham Lake,October,10/4/1994,1994,12700,0,900,13600
Ingham Lake,October,10/24/1994,1994,16700,0,1100,17800
Ingham Lake,October,10/27/1994,1994,13400,0,1300,14700
Ingham Lake,November,11/10/1994,1994,8800,0,22750,31550
Ingham Lake,April,4/4/1995,1995,3000,0,160,3160
Ingham Lake,October,10/4/1995,1995,7200,0,4000,11200
Ingham Lake,October,10/24/1995,1995,9900,0,5400,15300
Ingham Lake,October,10/25/1995,1995,14300,0,25540,39840
Ingham Lake,November,11/3/1995,1995,1300,0,300,1600
Ingham Lake,September,9/24/1996,1996,1225,0,4100,5325
Ingham Lake,September,9/25/1996,1996,3100,0,4800,7900
Ingham Lake,October,10/23/1996,1996,2720,0,13365,16085
Ingham Lake,April,4/16/1998,1998,0,0,250,250
Ingham Lake,September,9/22/1998,1998,750,0,75,825
Ingham Lake,October,10/19/1998,1998,22675,0,675,23350
Ingham Lake,November,11/2/1998,1998,1050,0,2200,3250
Ingham Lake,April,4/13/1999,1999,4500,0,4700,9200
Ingham Lake,October,10/19/1999,1999,6250,0,6400,12650
Ingham Lake,October,10/20/1999,1999,10050,0,26450,36500
Ingham Lake,November,11/3/1999,1999,19600,0,28300,47900
Ingham Lake,December,12/1/1999,1999,4315,0,33200,37515
Ingham Lake,October,10/16/2000,2000,2890,0,2400,5290
Ingham Lake,October,10/2/2001,2001,1950,0,400,2350
Ingham Lake,october,10/1/2002,2002,750,0,25,775
Ingham Lake,October,10/2/2002,2002,12150,0,500,12650
Ingham Lake,october,10/3/2002,2002,4000,0,150,4150
Ingham Lake,november,11/5/2002,2002,6300,0,45,6345
Ingham Lake,november,11/6/2002,2002,12600,0,75,12675
Ingham Lake,september,9/11/2003,2003,24020,0,2590,26610
Ingham Lake,September,9/23/2003,2003,700,0,50,750
Ingham Lake,october,10/9/2003,2003,125,0,900,1025
Ingham Lake,november,11/1/2003,2003,2300,0,20,2320
Ingham Lake,november,11/2/2003,2003,400,0,25,425
Ingham Lake,april,4/27/2004,2004,6500,0,700,7200
Ingham Lake,april,4/28/2004,2004,4850,0,500,5350
Ingham Lake,may,5/6/2004,2004,1500,0,300,1800
Ingham Lake,june,6/1/2005,2005,12700,0,8200,20900
Ingham Lake,june,6/6/2005,2005,5400,0,7600,13000
Ingham Lake,may,5/10/2006,2006,4700,0,8500,13200
Ingham Lake,april,4/2/2007,2007,31600,0,13500,45100
Ingham Lake,September,9/5/2008,2008,1575,0,425,2000
Ingham Lake,october,10/2/2008,2008,4500,0,3550,8050
Ingham Lake,october,10/25/2008,2008,850,0,6850,7700
Ingham Lake,October,10/26/2009,2009,8611,0,11345,19956
Ingham Lake,october,10/27/2009,2009,13839,0,8775,22614
Ingham Lake,September,9/21/2010,2010,5150,0,785,5935
Ingham Lake,October,10/9/2010,2010,3550,0,300,3850
Ingham Lake,September,9/20/2011,2011,2440,0,850,3290
Ingham Lake,October,10/8/2011,2011,2840,0,240,3080
Ingham Lake,October,10/8/2011,2011,12430,0,410,12840
Ingham Lake,November,11/10/2012,2012,11400,0,4350,15750
Ingham Lake,November,11/11/2012,2012,14400,0,3750,18150
Ingham Lake,November,11/13/2012,2012,4900,0,10285,15185
Ingham Lake,September,9/15/2013,2013,3850,0,3500,7350
Ingham Lake,September,9/27/2014,2014,37070,0,1970,39040
Ingham Lake,October,10/5/2014,2014,15100,0,2414,17514
Ingham Lake,October,10/2/2015,2015,14200,0,1480,15680
Ingham Lake,October,10/3/2015,2015,12550,0,2450,15000
Ingham Lake,October,10/16/2016,2016,12360,0,685,13045
Ingham Lake,October,10/17/2016,2016,6750,0,800,7550
Ingham Lake,October,10/31/2016,2016,2175,0,1050,3225
Ingham Lake,November,11/1/2016,2016,18140,0,169,18309
Ingham Lake,April,4/25/2017,2017,600,0,850,1450
Ingham Lake,May,5/8/2017,2017,2200,0,2500,4700
Iowa Lake,September,9/23/1996,1996,625,0,4700,5325
Iowa Lake,April,4/4/1997,1997,6455,870,4300,11625
Iowa Lake,September,9/22/1997,1997,250,175,3460,3885
Iowa Lake,April,4/13/1998,1998,13880,320,1200,15400
Iowa Lake,September,9/21/1998,1998,200,0,800,1000
Iowa Lake,November,11/11/1998,1998,3350,45,7650,11045
Iowa Lake,November,11/11/1998,1998,0,0,0,0
Iowa Lake,April,4/6/1999,1999,14300,1800,1100,17200
Iowa Lake,April,4/12/1999,1999,4000,800,4600,9400
Iowa Lake,September,9/29/1999,1999,17035,210,3700,20945
Iowa Lake,April,4/13/2000,2000,3300,0,10,3310
Iowa Lake,September,9/26/2000,2000,10100,0,100,10200
Iowa Lake,October,10/18/2000,2000,4710,0,3900,8610
Iowa Lake,October,10/3/2005,2005,2300,0,0,2300
Iowa Lake emmet co.,may,5/1/2006,2006,0,0,0,0
Iowa Lake emmet co.,September,9/15/2014,2014,281,0,3600,3881
Iowa Lake emmet co.,October,10/8/2015,2015,9867,0,11000,20867
Iowa Lake Osceola Co.,September,9/24/2003,2003,7100,30,150,7280
Iowa Lake Osceola Co.,September,9/25/2003,2003,6125,0,175,6300
Little Spirit Lake,May,5/5/1993,1993,1650,100,2300,4050
Little Spirit Lake,May,5/7/1993,1993,4500,0,11200,15700
Little Spirit Lake,May,5/8/1993,1993,1500,0,10300,11800
Little Spirit Lake,May,5/10/1993,1993,3400,0,2100,5500
Little Spirit Lake,May,5/13/1993,1993,4400,0,1300,5700
Little Spirit Lake,June,6/3/1993,1993,9400,0,1100,10500
Little Spirit Lake,May,5/31/1995,1995,1000,0,1600,2600
Little Spirit Lake,June,6/5/1995,1995,200,100,14600,14900
Little Spirit Lake,October,10/7/1996,1996,300,250,16500,17050
Little Spirit Lake,October,10/10/1996,1996,350,700,6500,7550
Little Spirit Lake,April,4/28/1997,1997,0,350,10340,10690
Little Spirit Lake,May,5/12/1997,1997,0,660,10770,11430
Little Spirit Lake,May,5/16/1997,1997,110,140,640,890
Little Spirit Lake,February,2/5/1999,1999,908,0,14475,15383
Little Spirit Lake,October,10/26/2000,2000,5400,300,4000,9700
Little Spirit Lake,november,11/5/2001,2001,6200,0,5100,11300
Little Spirit Lake,november,11/8/2001,2001,200,0,50,250
Little Spirit Lake,September,9/30/2002,2002,675,300,125,1100
Little Spirit Lake,October,10/1/2002,2002,700,250,8900,9850
Little Spirit Lake,October,10/28/2002,2002,12,0,10,22
Little Spirit Lake,may,5/3/2004,2004,200,7500,100,7800
Little Spirit Lake,october,10/2/2006,2006,7800,0,17000,24800
Little Spirit Lake,may,5/15/2007,2007,4200,0,6600,10800
Little Spirit Lake,may,5/12/2008,2008,6600,0,9400,16000
Little Spirit Lake,may,5/12/2008,2008,1100,0,2900,4000
Little Spirit lake,may,5/3/2010,2010,300,0,8250,8550
Little Swan Lake,September,9/19/1994,1994,10535,0,150,10685
Little Swan Lake,September,9/26/1994,1994,10800,0,3500,14300
Little Swan Lake,September,9/27/1994,1994,5100,0,6100,11200
Little Swan Lake,October,10/6/1994,1994,3800,0,240,4040
Little Swan Lake,March,3/28/1995,1995,7000,0,1500,8500
Little Swan Lake,September,9/20/1995,1995,4900,0,5600,10500
Little Swan Lake,September,9/21/1995,1995,7600,0,9400,17000
Little Swan Lake,September,9/30/1996,1996,4200,0,1040,5240
Little Swan Lake,October,10/1/1996,1996,3480,0,1125,4605
Little Swan Lake,May,5/26/1998,1998,4150,0,2100,6250
Little Swan Lake,October,10/14/1998,1998,7800,0,28400,36200
Little Swan Lake,June,6/7/1999,1999,1100,50,4200,5350
Little Swan Lake,October,10/11/1999,1999,20220,0,33474,53694
Little Swan Lake,November,11/10/1999,1999,3600,0,8550,12150
Little Swan Lake,October,10/30/2000,2000,1300,0,975,2275
Little Swan Lake,October,10/23/2001,2001,9730,0,2100,11830
Little Swan Lake,October,10/24/2001,2001,7100,0,4870,11970
Little Swan Lake,november,11/6/2001,2001,3190,0,2900,6090
Little Swan Lake,november,11/7/2001,2001,822,0,750,1572
Little Swan Lake,October,10/5/2004,2004,1450,0,50,1500
Little Swan Lake,October,10/6/2004,2004,1629,0,260,1889
little swan lake,october,10/4/2006,2006,1931,0,850,2781
little swan lake,october,10/5/2006,2006,11300,0,3365,14665
little swan lake,october,10/26/2007,2007,13100,0,1585,14685
little swan lake,october,10/29/2007,2007,4930,0,1135,6065
little swan lake,September,9/30/2008,2008,7400,0,4900,12300
little swan lake,September,10/1/2008,2008,6065,0,7100,13165
little swan lake,October,10/1/2010,2010,12250,0,1525,13775
Little Swan Lake,October,10/2/2010,2010,4100,0,415,4515
little swan lake,September,9/25/2011,2011,11165,0,24395,35560
little swan lake,October,10/1/2011,2011,6740,0,5900,12640
little swan lake,October,10/2/2011,2011,4110,0,6900,11010
little swan lake,April,4/17/2012,2012,1300,0,4200,5500
little swan lake,October,10/6/2013,2013,1825,0,6085,7910
Lost Island Lake,October,10/2/1984,1984,125,0,990,1115
Lost Island Lake,October,10/3/1984,1984,100,0,3500,3600
Lost Island Lake,October,10/4/1984,1984,246,0,16760,17006
Lost Island Lake,October,10/11/1984,1984,3300,31,11140,14471
Lost Island Lake,October,10/31/1984,1984,1710,75,5040,6825
Lost Island Lake,November,11/2/1984,1984,1390,425,60120,61935
Lost Island Lake,November,11/13/1984,1984,400,50,14640,15090
Lost Island Lake,November,11/14/1984,1984,270,0,3720,3990
Lost Island Lake,November,11/16/1984,1984,960,50,21156,22166
Lost Island Lake,November,11/24/1984,1984,77,45,5485,5607
Lost Island Lake,October,10/7/1985,1985,0,50,4000,4050
Lost Island Lake,October,10/8/1985,1985,1130,95,11408,12633
Lost Island Lake,October,10/9/1985,1985,649,100,15250,15999
Lost Island Lake,October,10/15/1985,1985,0,50,42893,42943
Lost Island Lake,October,10/16/1985,1985,2000,200,12250,14450
Lost Island Lake,October,10/29/1985,1985,250,60,10680,10990
Lost Island Lake,October,10/30/1985,1985,321,75,22612,23008
Lost Island Lake,November,11/13/1985,1985,105,0,4740,4845
Lost Island Lake,November,11/14/1985,1985,300,15,17915,18230
Lost Island Lake,October,10/1/1986,1986,297,10,3000,3307
Lost Island Lake,October,10/2/1986,1986,600,60,4000,4660
Lost Island Lake,October,10/6/1986,1986,9,30,7400,7439
Lost Island Lake,November,11/4/1986,1986,0,25,8920,8945
Lost Island Lake,November,11/5/1986,1986,18,10,14700,14728
Lost Island Lake,November,11/7/1986,1986,0,0,0,0
Lost Island Lake,November,11/10/1986,1986,22,12,8890,8924
Lost Island Lake,October,10/5/1987,1987,0,50,5500,5550
Lost Island Lake,November,11/2/1987,1987,50,0,39390,39440
Lost Island Lake,November,11/5/1987,1987,250,75,5600,5925
Lost Island Lake,November,11/17/1987,1987,250,100,4440,4790
Lost Island Lake,January,1/14/1989,1989,0,250,18600,18850
Lost Island Lake,May,5/3/1989,1989,0,0,0,0
Lost Island Lake,May,5/4/1989,1989,0,650,3500,4150
Lost Island Lake,May,5/17/1989,1989,0,0,7600,7600
Lost Island Lake,May,5/18/1989,1989,0,0,1100,1100
Lost Island Lake,May,5/22/1989,1989,150,100,3200,3450
Lost Island Lake,October,10/20/1989,1989,0,0,0,0
Lost Island Lake,January,1/8/1990,1990,313,749,3050,4112
Lost Island Lake,May,5/4/1990,1990,0,0,700,700
Lost Island Lake,May,5/5/1990,1990,0,50,7400,7450
Lost Island Lake,May,5/12/1990,1990,0,250,6200,6450
Lost Island Lake,April,4/23/1992,1992,2900,0,5450,8350
Lost Island Lake,April,4/23/1992,1992,1170,0,100,1270
Lost Island Lake,October,10/19/1992,1992,1200,0,1400,2600
Lost Island Lake,October,10/20/1992,1992,0,0,0,0
Lost Island Lake,May,5/3/1993,1993,666,500,2140,3306
Lost Island Lake,May,5/4/1993,1993,1600,200,2900,4700
Lost Island Lake,May,5/5/1993,1993,800,70,1300,2170
Lost Island Lake,November,11/8/1994,1994,100,0,1000,1100
Lost Island Lake,November,11/9/1994,1994,4300,0,1300,5600
Lost Island Lake,March,3/26/1996,1996,0,50,3500,3550
Lost Island Lake,April,4/10/1996,1996,44000,500,4500,49000
Lost Island Lake,April,4/6/1998,1998,6650,220,11705,18575
Lost Island Lake,April,4/9/1998,1998,1850,0,3865,5715
Lost Island Lake,April,4/13/1998,1998,400,0,539,939
Lost Island Lake,April,4/14/1998,1998,6650,0,1039,7689
Lost Island Lake,April,4/20/1998,1998,550,0,4826,5376
Lost Island Lake,April,4/21/1998,1998,0,0,5945,5945
Lost Island Lake,April,4/22/1998,1998,1750,0,900,2650
Lost Island Lake,May,5/6/1998,1998,7300,100,2000,9400
Lost Island Lake,May,5/7/1998,1998,19200,150,4600,23950
Lost Island Lake,May,5/11/1998,1998,5000,50,10650,15700
Lost Island Lake,May,5/12/1998,1998,950,50,6200,7200
Lost Island Lake,May,5/13/1998,1998,2000,20,4100,6120
Lost Island Lake,May,5/14/1998,1998,150,0,10100,10250
Lost Island Lake,May,5/27/1998,1998,2400,250,25400,28050
Lost Island Lake,May,5/29/1998,1998,12800,200,14050,27050
Lost Island Lake,June,6/2/1998,1998,2000,50,2500,4550
Lost Island Lake,June,6/3/1998,1998,11900,100,6500,18500
Lost Island Lake,June,6/4/1998,1998,7800,100,6400,14300
Lost Island Lake,June,6/9/1998,1998,5300,50,550,5900
Lost Island Lake,April,4/20/1999,1999,1100,150,1900,3150
Lost Island Lake,April,4/21/1999,1999,1800,100,2100,4000
Lost Island Lake,April,4/26/1999,1999,4300,100,23900,28300
Lost Island Lake,April,4/28/1999,1999,7700,300,19250,27250
Lost Island Lake,April,4/29/1999,1999,1500,50,8300,9850
Lost Island Lake,May,5/3/1999,1999,2100,50,7200,9350
Lost Island Lake,May,5/11/1999,1999,12400,240,56700,69340
Lost Island Lake,May,5/14/1999,1999,3400,100,14750,18250
Lost Island Lake,May,5/17/1999,1999,5600,100,26100,31800
Lost Island Lake,May,5/19/1999,1999,2400,150,12500,15050
Lost Island Lake,May,5/24/1999,1999,200,150,1500,1850
Lost Island Lake,May,5/26/1999,1999,1550,100,3900,5550
Lost Island Lake,May,5/27/1999,1999,2300,100,12030,14430
Lost Island Lake,October,10/15/1999,1999,0,100,4100,4200
Lost Island Lake,June,6/1/2000,2000,500,100,6500,7100
Lost Island Lake,June,6/2/2000,2000,100,0,1100,1200
Lost Island Lake,June,6/5/2000,2000,1500,0,4700,6200
Lost Island Lake,June,6/6/2000,2000,1200,0,11900,13100
Lost Island Lake,June,6/7/2000,2000,400,0,7200,7600
Lost Island Lake,June,6/8/2000,2000,2700,0,13800,16500
Lost Island Lake,June,6/12/2000,2000,1200,50,5100,6350
Lost Island Lake,October,10/10/2000,2000,450,40,3100,3590
Lost Island Lake,October,10/31/2000,2000,200,150,2300,2650
Lost Island Lake,may,5/15/2001,2001,26000,0,900,26900
Lost Island Lake,may,5/16/2001,2001,3000,0,700,3700
Lost Island Lake,may,5/18/2001,2001,7700,0,300,8000
Lost Island Lake,may,5/24/2001,2001,100,0,350,450
Lost Island Lake,May,5/30/2001,2001,1500,0,250,1750
Lost Island Lake,May,5/31/2001,2001,5100,0,400,5500
Lost Island Lake,June,6/4/2001,2001,3700,0,200,3900
Lost Island Lake,june,6/5/2001,2001,4000,0,400,4400
Lost Island Lake,june,6/6/2001,2001,4550,0,450,5000
Lost Island Lake,june,6/7/2001,2001,4100,0,450,4550
Lost Island Lake,October,10/10/2001,2001,100,0,4500,4600
Lost Island Lake,October,10/23/2001,2001,2500,0,1250,3750
Lost Island Lake,October,10/24/2001,2001,250,0,3400,3650
Lost Island Lake,May,5/7/2002,2002,1200,0,4100,5300
Lost Island Lake,may,5/15/2002,2002,400,0,15700,16100
Lost Island Lake,may,5/21/2002,2002,450,0,2700,3150
Lost Island Lake,may,5/23/2002,2002,700,0,4400,5100
Lost Island Lake,October,10/9/2002,2002,400,0,11900,12300
Lost Island Lake,april,4/23/2003,2003,11300,0,12500,23800
Lost Island Lake,may,5/7/2003,2003,9550,0,33100,42650
Lost Island Lake,may,5/12/2004,2004,11500,0,28750,40250
Lost Island Lake,may,2/25/2005,2005,4200,0,6800,11000
Lost Island Lake,june,6/2/2005,2005,1100,0,4400,5500
Lost Island Lake,may,5/2/2006,2006,12600,0,41000,53600
Lost Island Lake,may,5/9/2006,2006,800,0,6000,6800
Lost Island Lake,may,5/10/2006,2006,1100,0,1500,2600
Lost Island Lake,may,5/16/2006,2006,6000,0,500,6500
Lost Island Lake,may,5/25/2006,2006,300,0,8500,8800
Lost Island Lake,may,5/8/2008,2008,38000,200,41000,79200
Lost Island Lake,may,5/13/2008,2008,16500,100,20100,36700
Lost Island Lake,may,5/15/2008,2008,11300,0,26500,37800
Lost Island Lake,may,5/19/2008,2008,8500,100,39600,48200
Lost Island Lake,april,4/28/2009,2009,1600,50,13700,15350
Lost Island Lake,may,5/5/2009,2009,3500,0,28300,31800
Lost Island Lake,may,5/6/2009,2009,16700,200,48900,65800
Lost Island Lake,may,5/11/2009,2009,1500,50,13900,15450
Lost Island Lake,March,3/10/2010,2010,105779,100,73030,178909
Lost Island Lake,april,4/21/2010,2010,22300,150,24453,46903
Lost Island Lake,April,4/28/2010,2010,4400,100,17494,21994
Lost Island Lake,april,4/29/2010,2010,3500,0,44070,47570
Lost Island Lake,May,5/25/2010,2010,10200,50,38339,48589
Lost Island Lake,October,10/11/2010,2010,29400,50,48700,78150
Lost Island Lake,October,10/13/2010,2010,18300,40,24200,42540
Lost Island Lake,October,10/14/2010,2010,9400,20,36100,45520
Lost Island Lake,October,10/18/2010,2010,3600,60,14500,18160
Lost Island Lake,October,10/19/2010,2010,7100,50,5600,12750
Lost Island Lake,January,1/5/2011,2011,4300,50,3900,8250
Lost Island Lake,January,1/6/2011,2011,132761,732,98675,232168
Lost Island Lake,January,1/12/2011,2011,2200,40,2800,5040
Lost Island Lake,May,5/18/2011,2011,20,0,4300,4320
Lost Island Lake,May,5/19/2011,2011,1200,100,4000,5300
Lost Island Lake,November,11/12/2011,2011,5715,0,6260,11975
Lost Island Lake,November,11/13/2011,2011,38396,16,23536,61948
Lost Island Lake,November,11/19/2011,2011,17320,261,5105,22686
Lost Island Lake,November,11/28/2011,2011,24,0,6,30
Lost Island Lake,November,11/29/2011,2011,601,35,316,952
Lost Island Lake,March,3/26/2012,2012,21,0,33,54
Lost Island Lake,march,3/28/2012,2012,125,55,1192,1372
Lost Island Lake,March,3/29/2012,2012,440,12,850,1302
Lost Island Lake,March,3/30/2012,2012,250,7,900,1157
Lost Island Lake,May,5/5/2012,2012,16934,0,27982,44916
Lost Island Lake,November,11/9/2012,2012,575,0,720,1295
Lost Island Lake,June,6/3/2013,2013,150,300,3000,3450
Lost Island Lake,October,10/28/2013,2013,50,0,50,100
Lost Island Lake,May,5/10/2014,2014,5240,0,12685,17925
Lost Island Lake,May,5/19/2014,2014,611,0,4606,5217
Lost Island Lake,May,5/20/2014,2014,1000,0,1260,2260
Lost Island Lake,May,5/4/2015,2015,18815,35030,1285,55130
Lost Island Lake,October,10/17/2015,2015,1450,96,200,1746
Lost Island Lake,October,10/20/2015,2015,340,81,340,761
Lost Island Lake,May,5/8/2016,2016,15661,3050,14540,33251
Lost Island Lake,November,11/12/2016,2016,11,12,21,44
Lost Island Lake,November,11/13/2016,2016,337,218,404,959
Lost Island Lake,November,11/14/2016,2016,300,65,625,990
Lost Island Lake,May,5/7/2017,2017,10900,2000,9600,22500
Lost Island Lake,May,5/9/2017,2017,3900,950,1700,6550
Lost Island Lake,November,11/4/2017,2017,12794,3598,240,16632
Lost Island Lake,November,11/5/2017,2017,36,15,10,61
Lower Gar,May,5/14/1988,1988,960,600,1475,3035
Lower Gar,May,5/14/1988,1988,200,1100,1200,2500
Lower Gar,May,5/31/1988,1988,800,400,1300,2500
Lower Gar,May,5/31/1988,1988,200,100,2100,2400
Lower Gar,April,4/20/1989,1989,0,2100,24300,26400
Lower Gar,April,4/21/1989,1989,0,1100,5600,6700
Lower Gar,April,4/27/1989,1989,3200,700,14800,18700
Lower Gar,May,5/4/1989,1989,0,520,4100,4620
Lower Gar,May,5/11/1989,1989,0,1820,2625,4445
Lower Gar,May,5/18/1992,1992,0,460,945,1405
Lower Gar,May,5/21/1992,1992,0,85,136,221
Lower Gar,April,4/25/1996,1996,1600,500,3600,5700
Lower Gar,April,4/26/1996,1996,2400,3100,5600,11100
Lower Gar,June,6/3/1997,1997,1200,3500,11200,15900
Lower Gar,June,6/4/1997,1997,800,3600,3900,8300
Minnewashta,March,3/23/1984,1984,128,0,6500,6628
Minnewashta,January,1/13/1986,1986,2300,0,41114,43414
Minnewashta,January,1/30/1986,1986,0,125,7200,7325
Minnewashta,February,2/3/1988,1988,400,0,1700,2100
Minnewashta,April,4/20/1989,1989,0,0,2100,2100
Minnewashta,April,4/29/1996,1996,2300,2200,7600,12100
Minnewashta,May,5/17/1996,1996,1500,3200,500,5200
Silver Lake (Dickinson),October,10/25/1983,1983,120,0,150,270
Silver Lake (Dickinson),October,10/27/1983,1983,1100,0,1800,2900
Silver Lake (Dickinson),October,10/28/1983,1983,2010,0,1366,3376
Silver Lake (Dickinson),October,10/29/1983,1983,674,0,3592,4266
Silver Lake (Dickinson),October,10/30/1983,1983,8,0,40,48
Silver Lake (Dickinson),October,10/31/1983,1983,1726,0,665,2391
Silver Lake (Dickinson),November,11/1/1983,1983,100,0,500,600
Silver Lake (Dickinson),November,11/2/1983,1983,750,0,5300,6050
Silver Lake (Dickinson),November,11/4/1983,1983,680,0,1550,2230
Silver Lake (Dickinson),November,11/5/1983,1983,200,0,650,850
Silver Lake (Dickinson),November,11/6/1983,1983,150,0,2120,2270
Silver Lake (Dickinson),November,11/7/1983,1983,67,0,2979,3046
Silver Lake (Dickinson),November,11/20/1983,1983,400,0,2000,2400
Silver Lake (Dickinson),November,11/21/1983,1983,650,0,4450,5100
Silver Lake (Dickinson),November,11/22/1983,1983,280,0,1850,2130
Silver Lake (Dickinson),December,12/7/1983,1983,10,0,100,110
Silver Lake (Dickinson),December,12/8/1983,1983,0,0,50,50
Silver Lake (Dickinson),December,12/15/1983,1983,30,0,850,880
Silver Lake (Dickinson),December,12/16/1983,1983,0,0,230,230
Silver Lake (Dickinson),December,12/17/1983,1983,10,0,220,230
Silver Lake (Dickinson),January,1/25/1984,1984,0,0,68,68
Silver Lake (Dickinson),January,1/26/1984,1984,0,0,60,60
Silver Lake (Dickinson),January,1/27/1984,1984,0,0,50,50
Silver Lake (Dickinson),January,1/28/1984,1984,6,0,0,6
Silver Lake (Dickinson),January,1/29/1984,1984,16,0,0,16
Silver Lake (Dickinson),April,4/18/1989,1989,0,0,80,80
Silver Lake (Dickinson),April,4/20/1989,1989,2750,15,550,3315
Silver Lake (Dickinson),April,4/21/1989,1989,12,0,550,562
Silver Lake (Dickinson),September,9/21/1990,1990,12000,250,3000,15250
Silver Lake (Dickinson),September,9/23/1990,1990,150,10,150,310
Silver Lake (Dickinson),September,9/27/1990,1990,0,0,500,500
Silver Lake (Dickinson),September,9/29/1990,1990,150,30,450,630
Silver Lake (Dickinson),October,10/4/1990,1990,250,40,600,890
Silver Lake (Dickinson),October,10/12/1990,1990,1700,50,4500,6250
Silver Lake (Dickinson),October,10/14/1990,1990,300,30,700,1030
Silver Lake (Dickinson),October,10/15/1990,1990,320,20,800,1140
Silver Lake (Dickinson),October,10/16/1990,1990,500,100,4000,4600
Silver Lake (Dickinson),October,10/19/1990,1990,0,0,5000,5000
Silver Lake (Dickinson),October,10/20/1990,1990,0,25,1500,1525
Silver Lake (Dickinson),October,10/28/1990,1990,2000,100,4000,6100
Silver Lake (Dickinson),October,10/29/1990,1990,100,25,8000,8125
Silver Lake (Dickinson),November,11/8/1994,1994,400,0,13000,13400
Silver Lake (Dickinson),November,11/10/1994,1994,5000,500,15000,20500
Silver Lake (Dickinson),November,11/14/1994,1994,700,50,3000,3750
Silver Lake (Dickinson),November,11/16/1994,1994,0,0,0,0
Silver Lake (Dickinson),November,11/19/1994,1994,3000,100,6000,9100
Silver Lake (Dickinson),October,10/22/1996,1996,550,100,1000,1650
Silver Lake (Dickinson),October,10/24/1996,1996,4200,200,2000,6400
Silver Lake (Dickinson),October,10/26/1996,1996,100,50,100,250
Silver Lake (Dickinson),October,10/28/1996,1996,2500,0,5000,7500
Silver Lake (Dickinson),November,11/5/1996,1996,700,50,10400,11150
Silver Lake (Dickinson),October,10/25/1997,1997,200,150,400,750
Silver Lake (Dickinson),October,10/26/1997,1997,350,160,900,1410
Silver Lake (Dickinson),October,10/29/1997,1997,26050,750,24300,51100
Silver Lake (Dickinson),November,11/4/1997,1997,1500,580,5600,7680
Silver Lake (Dickinson),November,11/6/1997,1997,8500,1920,14850,25270
Silver Lake (Dickinson),November,11/8/1997,1997,1050,900,9500,11450
Silver Lake (Dickinson),November,11/9/1997,1997,4100,800,350,5250
Silver Lake (Dickinson),October,10/11/1998,1998,130,75,300,505
Silver Lake (Dickinson),October,10/13/1998,1998,3300,850,1800,5950
Silver Lake (Dickinson),November,11/15/1998,1998,100,50,1100,1250
Silver Lake (Dickinson),November,11/16/1998,1998,300,400,2200,2900
Silver Lake (Dickinson),November,11/17/1998,1998,300,50,2500,2850
Silver Lake (Dickinson),November,11/3/1999,1999,4010,100,8180,12290
Silver Lake (Dickinson),November,11/4/1999,1999,6600,0,4150,10750
Silver Lake (Dickinson),November,11/13/2001,2001,600,0,5000,5600
Silver Lake (Dickinson),October,10/7/2002,2002,1,250,18,269
Silver Lake (Dickinson),October,10/9/2002,2002,0,1000,400,1400
Silver Lake (Dickinson),October,10/10/2002,2002,0,200,300,500
Silver Lake (Dickinson),october,10/7/2003,2003,2880,120,760,3760
Silver Lake (Dickinson),november,11/5/2003,2003,10100,5665,21161,36926
Silver Lake (Dickinson),October,10/7/2004,2004,2010,670,778,3458
Silver Lake (Dickinson),november,11/2/2004,2004,12,200,1100,1312
Silver Lake (Dickinson),november,11/3/2004,2004,208,340,490,1038
Silver Lake (Dickinson),may,5/13/2005,2005,2300,0,6500,8800
Silver Lake (Dickinson),may,5/11/2006,2006,1600,0,6800,8400
Silver Lake (Dickinson),may,5/12/2006,2006,2100,0,4700,6800
Silver Lake (Dickinson),may,5/15/2006,2006,3100,0,3800,6900
Silver Lake (Dickinson),april,4/18/2007,2007,100,0,700,800
Silver Lake (Dickinson),April,4/23/2010,2010,3200,250,20400,23850
Silver Lake (Dickinson),April,4/30/2012,2012,2200,200,7400,9800
Silver Lake (Dickinson),April,4/30/2013,2013,10800,500,22300,33600
Silver Lake (Dickinson),April,4/22/2014,2014,5300,5200,12600,23100
Silver Lake (Dickinson),April,4/25/2014,2014,1100,550,2600,4250
Silver Lake (Dickinson),May,5/20/2014,2014,6500,6600,15300,28400
Silver Lake (Dickinson),May,5/19/2015,2015,2100,2950,11800,16850
Silver Lake (Dickinson),October,10/23/2015,2015,13470,1000,4790,19260
Silver Lake (Palo Alto),April,4/3/1990,1990,5,0,3600,3605
Silver Lake (Palo Alto),April,4/4/1990,1990,0,0,6400,6400
Silver Lake (Palo Alto),October,10/19/1990,1990,0,0,1600,1600
Silver Lake (Palo Alto),July,7/29/1991,1991,0,0,3300,3300
Silver Lake (Palo Alto),July,7/30/1991,1991,0,0,7500,7500
Silver Lake (Palo Alto),July,7/31/1991,1991,0,0,9700,9700
Silver Lake (Palo Alto),August,8/1/1991,1991,0,0,2300,2300
Silver Lake (Palo Alto),August,8/12/1991,1991,0,0,1800,1800
Silver Lake (Palo Alto),August,8/13/1991,1991,0,0,9600,9600
Silver Lake (Palo Alto),August,8/14/1991,1991,0,0,8000,8000
Silver Lake (Palo Alto),August,8/15/1991,1991,0,0,7800,7800
Silver Lake (Palo Alto),August,8/6/1992,1992,0,0,1200,1200
Silver Lake (Palo Alto),August,8/7/1992,1992,0,0,8500,8500
Silver Lake (Palo Alto),July,7/27/1993,1993,0,0,9000,9000
Silver Lake (Palo Alto),July,7/28/1993,1993,0,0,7500,7500
Silver Lake (Palo Alto),May,5/9/1994,1994,0,0,12000,12000
Silver Lake (Palo Alto),May,5/10/1994,1994,0,0,400,400
Silver Lake (Palo Alto),May,5/16/1994,1994,0,0,8000,8000
Silver Lake (Palo Alto),May,5/17/1994,1994,0,0,1000,1000
Silver Lake (Palo Alto),October,10/24/1994,1994,0,0,22900,22900
Silver Lake (Palo Alto),October,10/31/1994,1994,0,0,4700,4700
Silver Lake (Palo Alto),November,11/1/1994,1994,0,0,4300,4300
Silver Lake (Palo Alto),November,11/2/1994,1994,0,0,3500,3500
Silver Lake (Palo Alto),November,11/7/1994,1994,0,0,8500,8500
Silver Lake (Palo Alto),November,11/8/1994,1994,0,0,17800,17800
Silver Lake (Palo Alto),May,5/1/1995,1995,0,0,200,200
Silver Lake (Palo Alto),May,5/2/1995,1995,0,0,600,600
Silver Lake (Palo Alto),October,10/23/1995,1995,0,0,5200,5200
Silver Lake (Palo Alto),October,10/24/1995,1995,0,0,21800,21800
Silver Lake (Palo Alto),October,10/31/1995,1995,0,0,8500,8500
Silver Lake (Palo Alto),May,5/13/1996,1996,0,0,800,800
Silver Lake (Palo Alto),October,10/19/1998,1998,0,0,8200,8200
Silver Lake (Palo Alto),October,10/20/1998,1998,0,0,2000,2000
Silver Lake (Palo Alto),September,9/14/1999,1999,0,0,9200,9200
Silver Lake (Palo Alto),September,9/15/1999,1999,0,0,8600,8600
Silver Lake (Palo Alto),October,10/9/2001,2001,800,0,5100,5900
Silver Lake (Palo Alto),October,10/10/2001,2001,1800,0,10000,11800
Silver Lake (Palo Alto),October,10/28/2002,2002,3400,0,1500,4900
Silver Lake (Palo Alto),October,10/29/2002,2002,3400,0,1375,4775
Silver Lake (Palo Alto),november,11/4/2002,2002,2115,0,42000,44115
Silver Lake (Palo Alto),november,11/11/2002,2002,2200,0,1600,3800
Silver Lake (Palo Alto),november,11/11/2003,2003,9000,0,47000,56000
Silver Lake (Palo Alto),november,11/9/2004,2004,1320,0,13920,15240
Silver Lake (Palo Alto),november,11/22/2004,2004,1500,0,500,2000
Silver Lake (Palo Alto),may,5/17/2006,2006,250,0,3500,3750
Silver Lake (Palo Alto),may,5/17/2006,2006,250,0,3500,3750
Silver Lake (Palo Alto),october,10/2/2006,2006,4500,0,20500,25000
Silver Lake (Palo Alto),September,9/28/2010,2010,31800,0,27500,59300
Silver Lake (Palo Alto),September,9/7/2012,2012,14930,0,11860,26790
Silver Lake (Palo Alto),September,9/14/2012,2012,1320,0,4550,5870
Silver Lake (Palo Alto),September,9/15/2012,2012,1120,0,3025,4145
Silver Lake (Palo Alto),September,9/16/2012,2012,6535,0,4900,11435
Silver Lake (Palo Alto),November,11/2/2012,2012,6300,0,15495,21795
Silver Lake (Palo Alto),November,11/3/2012,2012,5100,0,10500,15600
Silver Lake (Palo Alto),September,9/27/2013,2013,10210,0,6955,17165
Silver Lake (Palo Alto),September,9/28/2013,2013,3710,0,2520,6230
Silver Lake (Palo Alto),October,10/11/2013,2013,1245,0,415,1660
Silver Lake (Palo Alto),October,10/12/2013,2013,1180,0,210,1390
Silver Lake (Palo Alto),October,10/18/2014,2014,5300,0,950,6250
Silver Lake (Palo Alto),October,10/19/2014,2014,1600,0,125,1725
Silver Lake (Palo Alto),October,10/20/2014,2014,4450,0,16050,20500
Silver Lake (Palo Alto),october,10/13/2015,2015,8500,0,1050,9550
Silver Lake (Palo Alto),October,10/14/2015,2015,8500,0,1050,9550
Silver Lake (Palo Alto),October,,2009,32800,0,21980,54780
Spirit Lake,February,2/20/1985,1985,16,0,15000,15016
Spirit Lake,May,5/12/1986,1986,8300,4000,10200,22500
Spirit Lake,May,5/13/1986,1986,17900,2250,23500,43650
Spirit Lake,May,5/15/1986,1986,1150,1440,12075,14665
Spirit Lake,February,2/27/1988,1988,16800,0,72700,89500
Spirit Lake,May,5/17/1988,1988,200,100,300,600
Spirit Lake,March,3/8/1989,1989,3200,0,27500,30700
Spirit Lake,May,5/9/1989,1989,0,1100,15200,16300
Spirit Lake,May,5/15/1989,1989,1200,300,17400,18900
Spirit Lake,May,5/24/1989,1989,0,0,2100,2100
Spirit Lake,April,4/21/1990,1990,1200,350,14520,16070
Spirit Lake,April,4/22/1990,1990,0,590,15320,15910
Spirit Lake,April,4/25/1990,1990,0,450,11650,12100
Spirit Lake,May,5/3/1990,1990,0,0,50,50
Spirit Lake,May,5/25/1990,1990,2100,0,8700,10800
Spirit Lake,May,5/18/1992,1992,134,1349,430,1913
Spirit Lake,May,5/19/1992,1992,0,2196,960,3156
Spirit Lake,May,5/20/1992,1992,880,0,0,880
Spirit Lake,May,5/21/1992,1992,65,64,52,181
Spirit Lake,June,6/3/1992,1992,98,78,90,266
Spirit Lake,April,4/29/1993,1993,6500,12145,13190,31835
Spirit Lake,April,4/30/1993,1993,3600,650,2340,6590
Spirit Lake,May,5/20/1993,1993,1400,0,6800,8200
Spirit Lake,May,5/27/1993,1993,1100,0,1250,2350
Spirit Lake,June,6/10/1993,1993,8800,0,6200,15000
Spirit Lake,April,4/30/1994,1994,100,100,500,700
Spirit Lake,May,5/2/1994,1994,200,150,2200,2550
Spirit Lake,May,5/16/1994,1994,250,200,3450,3900
Spirit Lake,May,5/16/1995,1995,0,0,14600,14600
Spirit Lake,May,5/17/1995,1995,350,0,4200,4550
Spirit Lake,May,5/18/1995,1995,650,0,900,1550
Spirit Lake,May,5/19/1995,1995,300,0,2200,2500
Spirit Lake,May,5/19/1995,1995,0,0,1700,1700
Spirit Lake,June,6/1/1995,1995,400,450,4100,4950
Spirit Lake,June,6/2/1995,1995,5600,1400,8100,15100
Spirit Lake,June,6/7/1995,1995,400,100,17200,17700
Spirit Lake,June,6/13/1995,1995,0,0,300,300
Spirit Lake,June,6/15/1995,1995,700,100,4200,5000
Spirit Lake,April,4/24/1996,1996,0,200,6500,6700
Spirit Lake,May,5/6/1996,1996,12400,15500,13200,41100
Spirit Lake,May,5/8/1996,1996,1100,3100,1700,5900
Spirit Lake,May,5/13/1996,1996,600,2700,37500,40800
Spirit Lake,May,5/22/1996,1996,15500,8100,92500,116100
Spirit Lake,May,5/30/1996,1996,200,1500,9500,11200
Spirit Lake,June,6/3/1996,1996,200,2100,19700,22000
Spirit Lake,June,6/4/1996,1996,0,0,0,0
Spirit Lake,June,6/6/1996,1996,5100,1600,18300,25000
Spirit Lake,March,3/2/1997,1997,300,550,390,1240
Spirit Lake,April,4/21/1997,1997,18600,16950,42500,78050
Spirit Lake,April,4/23/1997,1997,0,1500,2100,3600
Spirit Lake,April,4/24/1997,1997,0,0,900,900
Spirit Lake,April,4/25/1997,1997,0,0,6500,6500
Spirit Lake,April,4/25/1997,1997,0,3300,7800,11100
Spirit Lake,April,4/30/1997,1997,0,0,7050,7050
Spirit Lake,May,5/5/1997,1997,0,0,0,0
Spirit Lake,June,5/9/1997,1997,0,0,7810,7810
Spirit Lake,May,5/20/1997,1997,2000,1750,12700,16450
Spirit Lake,May,5/21/1997,1997,700,1100,5400,7200
Spirit Lake,May,5/27/1997,1997,300,275,1700,2275
Spirit Lake,June,5/28/1997,1997,0,0,11200,11200
Spirit Lake,May,5/28/1997,1997,900,1100,17100,19100
Spirit Lake,May,5/30/1997,1997,100,0,350,450
Spirit Lake,June,6/5/1997,1997,16200,4600,31400,52200
Spirit Lake,April,4/27/1998,1998,100,1400,2740,4240
Spirit Lake,May,5/18/1998,1998,3650,250,1200,5100
Spirit Lake,May,5/21/1998,1998,7500,650,800,8950
Spirit Lake,April,4/23/1999,1999,200,50,13900,14150
Spirit Lake,May,5/5/1999,1999,75,50,5100,5225
Spirit Lake,May,5/10/1999,1999,2800,2800,7200,12800
Spirit Lake,May,5/17/1999,1999,1400,50,10800,12250
Spirit Lake,May,5/17/1999,1999,2100,450,36200,38750
Spirit Lake,May,5/19/1999,1999,4400,500,2100,7000
Spirit Lake,May,5/20/1999,1999,300,100,6900,7300
Spirit Lake,May,5/20/1999,1999,200,0,4300,4500
Spirit Lake,May,5/20/1999,1999,100,0,700,800
Spirit Lake,May,5/16/2000,2000,400,475,8400,9275
Spirit Lake,May,5/22/2000,2000,150,250,6550,6950
Spirit Lake,May,5/30/2000,2000,1300,50,10900,12250
Spirit Lake,april,4/19/2001,2001,3500,500,7000,11000
Spirit Lake,April,4/25/2001,2001,5500,3800,8500,17800
Spirit Lake,May,5/1/2001,2001,650,4500,35000,40150
Spirit Lake,may,5/3/2001,2001,9500,4500,1500,15500
Spirit Lake,may,5/7/2001,2001,100,300,4500,4900
Spirit Lake,may,5/11/2001,2001,5200,500,12000,17700
Spirit Lake,may,5/14/2001,2001,50,0,150,200
Spirit Lake,may,5/15/2001,2001,4900,500,0,5400
Spirit Lake,april,4/24/2002,2002,450,4200,11700,16350
Spirit Lake,May,5/7/2002,2002,200,1300,25300,26800
Spirit Lake,june,6/5/2002,2002,100,1300,7100,8500
Spirit Lake,may,5/6/2003,2003,4800,1100,4800,10700
Spirit Lake,may,5/21/2003,2003,2450,400,7200,10050
Spirit Lake,May,5/22/2003,2003,2100,100,17800,20000
Spirit Lake,may,5/14/2004,2004,4300,600,6100,11000
spirit lake,may,5/18/2004,2004,7300,0,12100,19400
Spirit Lake,april,4/19/2005,2005,21300,10100,45500,76900
Spirit Lake,may,5/9/2005,2005,13700,22100,4800,40600
Spirit Lake,may,5/11/2005,2005,2100,8600,14000,24700
Spirit Lake,may,5/18/2005,2005,1500,9200,10800,21500
Spirit Lake,april,4/10/2006,2006,2400,500,18100,21000
Spirit Lake,april,4/13/2006,2006,2200,800,12000,15000
Spirit Lake,april,4/17/2006,2006,6500,2200,3800,12500
Spirit Lake,april,4/24/2006,2006,2900,1100,13500,17500
Spirit Lake,may,5/2/2006,2006,2600,1100,3700,7400
Spirit Lake,may,5/3/2006,2006,1200,1800,1600,4600
Spirit Lake,june,6/1/2006,2006,2600,3500,1650,7750
Spirit Lake,june,6/5/2006,2006,3700,200,1200,5100
Spirit Lake,june,6/6/2006,2006,3200,100,1800,5100
Spirit Lake,may,5/7/2007,2007,19600,9300,22400,51300
Spirit Lake,may,5/10/2007,2007,3600,7400,9500,20500
Spirit Lake,may,5/1/2008,2008,8700,12300,21400,42400
Spirit Lake,may,5/1/2008,2008,1400,1100,2800,5300
Spirit Lake,May,5/14/2009,2009,3500,5400,20500,29400
Spirit Lake,May,5/17/2010,2010,37000,38700,4200,79900
Spirit Lake,May,5/11/2011,2011,4900,41300,6500,52700
Spirit Lake,April,4/3/2012,2012,4600,3400,18300,26300
Spirit Lake,April,4/18/2012,2012,4000,5300,11200,20500
Spirit Lake,May,5/8/2013,2013,17000,6300,20250,43550
Spirit Lake,May,5/9/2013,2013,200,100,100,400
Spirit Lake,May,5/15/2013,2013,19200,4100,19350,42650
Spirit Lake,April,4/30/2014,2014,2200,400,3700,6300
Spirit Lake,April,4/28/2015,2015,12300,26100,19200,57600
Spirit Lake,May,5/5/2015,2015,8200,9800,4900,22900
Spirit Lake,May,5/6/2015,2015,6100,1100,8200,15400
Spirit Lake,May,5/12/2015,2015,50,100,100,250
Spirit Lake,April,4/26/2016,2016,20600,4600,4200,29400
Spirit Lake,May,5/11/2016,2016,5900,3900,1100,10900
Spirit Lake,May,5/15/2016,2016,12200,100,500,12800
Spirit Lake,May,5/10/2017,2017,1300,100,2200,3600
Spirit Lake,May,5/17/2017,2017,1100,150,2600,3850
Trumbull Lake,May,5/1/1999,1999,400,50,1600,2050
Trumbull Lake,May,5/1/1999,1999,400,0,1600,2000
Trumbull Lake,June,6/2/1999,1999,800,0,1400,2200
Trumbull Lake,June,6/3/1999,1999,1200,0,2100,3300
Trumbull Lake,October,10/14/1999,1999,3250,0,11600,14850
Trumbull Lake,October,10/18/1999,1999,12600,0,14200,26800
Trumbull Lake,October,10/17/2000,2000,300,0,700,1000
Trumbull Lake,October,10/18/2000,2000,2000,0,4000,6000
Trumbull Lake,October,10/29/2001,2001,4000,0,19780,23780
Trumbull Lake,april,4/7/2002,2002,400,0,8000,8400
Trumbull Lake,may,5/6/2002,2002,1700,0,5000,6700
Trumbull Lake,0ctober,10/7/2002,2002,1600,0,11000,12600
Trumbull Lake,october,10/8/2002,2002,250,0,14000,14250
Trumbull Lake,october,10/21/2002,2002,4600,0,6000,10600
Trumbull Lake,October,10/22/2002,2002,3625,0,5000,8625
Trumbull Lake,october,10/6/2003,2003,1000,0,6000,7000
Trumbull Lake,October,10/7/2003,2003,1000,0,9000,10000
Trumbull Lake,October,10/18/2004,2004,6100,0,10050,16150
Trumbull Lake,October,10/19/2004,2004,1600,0,4700,6300
Trumbull Lake,October,10/25/2004,2004,900,0,6500,7400
Trumbull Lake,October,10/26/2004,2004,3250,0,5700,8950
Trumbull Lake,november,11/8/2004,2004,1000,0,1200,2200
Trumbull Lake,September,9/19/2005,2005,500,0,27000,27500
Trumbull Lake,october,10/10/2005,2005,2700,0,8000,10700
Trumbull Lake,October,10/31/2005,2005,4600,0,21600,26200
Trumbull Lake,november,11/14/2005,2005,1400,0,24100,25500
Trumbull Lake,may,5/15/2006,2006,8000,0,300,8300
Trumbull Lake,September,9/18/2006,2006,850,0,40000,40850
Trumbull Lake,September,9/20/2006,2006,850,0,40000,40850
Trumbull Lake,october,10/16/2007,2007,2500,0,1000,3500
Trumbull Lake,october,10/17/2007,2007,6000,0,2000,8000
Trumbull Lake,october,10/30/2007,2007,1800,0,1800,3600
Trumbull Lake,october,10/27/2008,2008,10700,0,13500,24200
Trumbull Lake,november,11/3/2008,2008,7000,0,14400,21400
Trumbull Lake,September,9/22/2009,2009,1750,0,14250,16000
Trumbull Lake,november,11/17/2009,2009,2500,0,50,2550
Trumbull Lake,november,11/18/2009,2009,3150,0,0,3150
Trumbull Lake,October,10/5/2010,2010,16950,0,58500,75450
Trumbull Lake,October,10/14/2010,2010,8400,0,48050,56450
Tuttle Lake,January,1/2/1989,1989,750,0,500,1250
Tuttle Lake,January,1/3/1989,1989,0,0,500,500
Tuttle Lake,January,1/4/1989,1989,3400,0,7200,10600
Tuttle Lake,January,1/5/1989,1989,19400,0,34000,53400
Tuttle Lake,December,12/26/1989,1989,7300,0,990,8290
Tuttle Lake,December,12/27/1989,1989,5100,0,1200,6300
Tuttle Lake,January,1/14/1991,1991,120,0,550,670
Tuttle Lake,January,1/15/1991,1991,150,0,250,400
Tuttle Lake,January,1/16/1991,1991,2600,0,11800,14400
Tuttle Lake,January,1/18/1991,1991,10400,0,14560,24960
Tuttle Lake,January,1/25/1991,1991,18850,0,4100,22950
Tuttle Lake,January,1/31/1991,1991,2750,0,1770,4520
Tuttle Lake,January,1/9/1992,1992,50,0,175,225
Tuttle Lake,January,1/10/1992,1992,75,0,100,175
Tuttle Lake,January,1/11/1992,1992,130,0,260,390
Tuttle Lake,January,1/20/1992,1992,75,0,150,225
Tuttle Lake,April,4/4/1994,1994,8000,0,1000,9000
Tuttle Lake,April,4/6/1994,1994,35500,0,33900,69400
Tuttle Lake,March,3/27/1995,1995,600,0,1400,2000
Tuttle Lake,April,4/5/1995,1995,10620,0,1780,12400
Tuttle Lake,April,4/6/1995,1995,21540,0,14450,35990
Tuttle Lake,September,9/19/1995,1995,2100,0,5900,8000
Tuttle Lake,April,4/8/1996,1996,19200,0,12700,31900
Tuttle Lake,April,4/9/1996,1996,11050,0,8500,19550
Tuttle Lake,April,4/29/1996,1996,12900,0,3200,16100
Tuttle Lake,April,4/30/1996,1996,9480,0,8000,17480
Tuttle Lake,May,5/7/1996,1996,2420,0,8800,11220
Tuttle Lake,May,5/8/1996,1996,9255,0,8500,17755
Tuttle Lake,October,10/3/1996,1996,1025,0,13810,14835
Tuttle Lake,Feb.,2/12/1998,1998,900,0,11550,12450
Tuttle Lake,October,10/19/1998,1998,1500,0,16200,17700
Tuttle Lake,October,10/21/1998,1998,300,0,4800,5100
Tuttle Lake,June,6/9/1999,1999,1200,100,4300,5600
Tuttle Lake,June,6/10/1999,1999,1100,0,5600,6700
Tuttle Lake,April,4/12/2000,2000,250,0,775,1025
Tuttle Lake,September,9/27/2000,2000,4250,0,11775,16025
Tuttle Lake,October,10/10/2000,2000,1974,0,11200,13174
Tuttle Lake,October,10/3/2001,2001,200,0,100,300
Tuttle Lake,October,10/10/2002,2002,200,0,300,500
Tuttle Lake,april,4/6/2004,2004,900,0,350,1250
Tuttle Lake,October,10/12/2004,2004,4000,0,75,4075
Tuttle Lake,October,10/19/2004,2004,2700,0,2100,4800
Tuttle Lake,October,10/20/2004,2004,1650,0,2760,4410
Tuttle Lake,October,10/21/2004,2004,4315,0,600,4915
Tuttle Lake,October,10/19/2005,2005,145,0,585,730
Tuttle Lake,may,5/24/2006,2006,1300,0,7500,8800
Tuttle Lake,june,6/11/2006,2006,2250,0,27000,29250
Tuttle Lake,june,6/13/2006,2006,2250,0,27000,29250
Tuttle Lake,September,9/6/2006,2006,8500,0,21000,29500
Tuttle Lake,September,9/25/2006,2006,250,0,25500,25750
Tuttle Lake,october,10/4/2006,2006,8600,0,42000,50600
Tuttle Lake,june,6/3/2008,2008,2200,0,6700,8900
Tuttle Lake,june,6/3/2008,2008,13900,0,3700,17600
Tuttle Lake,april,4/20/2009,2009,6500,0,32300,38800
Tuttle Lake,may,5/4/2009,2009,7400,0,18100,25500
Tuttle Lake,may,5/6/2010,2010,17850,100,19949,37899
Tuttle Lake,may,5/10/2010,2010,1000,0,550,1550
Tuttle Lake,may,5/11/2010,2010,2100,0,8950,11050
Tuttle Lake,April,4/28/2011,2011,100,0,700,800
Tuttle Lake,May,5/2/2011,2011,2100,0,4700,6800
Tuttle Lake,March,3/28/2012,2012,6200,1400,16700,24300
Tuttle Lake,May,5/1/2012,2012,1700,400,4900,7000
Tuttle Lake,April,4/20/2013,2013,25060,0,31325,56385
Tuttle Lake,April,4/29/2013,2013,15480,0,950,16430
Tuttle Lake,September,9/14/2013,2013,10,0,2890,2900
Tuttle Lake,September,9/16/2013,2013,3350,0,3200,6550
Tuttle Lake,October,10/7/2013,2013,1520,0,1215,2735
Tuttle Lake,October,10/13/2013,2013,11820,0,1385,13205
Tuttle Lake,September,9/13/2014,2014,120,0,2205,2325
Tuttle Lake,September,9/14/2014,2014,85,0,4200,4285
Tuttle Lake,November,11/1/2014,2014,5360,0,35000,40360
Tuttle Lake,November,11/3/2014,2014,1150,0,25523,26673
Tuttle Lake,October,10/6/2015,2015,9867,0,11000,20867
Tuttle Lake,October,10/7/2015,2015,9867,0,11000,20867
Upper Gar,May,5/20/1992,1992,47,96,1425,1568
Virgin Lake,October,10/28/1997,1997,1100,0,24800,25900
Virgin Lake,November,11/4/1998,1998,0,0,500,500
Virgin Lake,May,5/20/1999,1999,200,0,4500,4700
Virgin Lake,October,10/23/2000,2000,1200,100,3300,4600
Virgin Lake,october,10/13/2003,2003,8800,0,1000,9800
Virgin Lake,october,10/2/2007,2007,33700,0,3000,36700
Virgin Lake,october,10/31/2007,2007,500,0,100,600
Virgin Lake,September,9/9/2009,2009,18200,0,17400,35600
Virgin Lake,September,9/21/2009,2009,1500,0,5800,7300
Virgin Lake,October,10/13/2010,2010,1450,0,50,1500
West Okoboji Lake,January,1/2/1984,1984,0,0,0,0
West Okoboji Lake,January,1/29/1984,1984,0,0,0,0
West Okoboji Lake,February,2/3/1984,1984,0,500,375,875
West Okoboji Lake,February,2/9/1984,1984,140500,125,55500,196125
West Okoboji Lake,March,3/9/1984,1984,0,0,0,0
West Okoboji Lake,March,3/15/1984,1984,500,0,500,1000
West Okoboji Lake,March,3/26/1984,1984,750,5,750,1505
West Okoboji Lake,January,1/23/1985,1985,2000,50,1500,3550
West Okoboji Lake,January,1/24/1985,1985,150,75,1375,1600
West Okoboji Lake,January,1/26/1985,1985,25000,25,25000,50025
West Okoboji Lake,January,1/28/1985,1985,9,0,30,39
West Okoboji Lake,January,1/29/1985,1985,24500,375,5000,29875
West Okoboji Lake,February,2/4/1985,1985,75000,28,5250,80278
West Okoboji Lake,February,2/6/1985,1985,7250,0,21875,29125
West Okoboji Lake,February,2/13/1985,1985,18,0,20,38
West Okoboji Lake,February,2/15/1985,1985,35,0,18,53
West Okoboji Lake,February,2/18/1985,1985,0,0,24,24
West Okoboji Lake,March,3/7/1985,1985,4000,1,625,4626
West Okoboji Lake,December,12/27/1985,1985,0,0,0,0
West Okoboji Lake,January,1/2/1986,1986,100,4000,200,4300
West Okoboji Lake,January,1/15/1986,1986,19750,0,9750,29500
West Okoboji Lake,January,1/20/1986,1986,100,0,45,145
West Okoboji Lake,February,2/11/1986,1986,5625,0,7500,13125
West Okoboji Lake,February,2/26/1986,1986,142008,3720,31574,177302
West Okoboji Lake,March,3/15/1986,1986,0,0,0,0
West Okoboji Lake,January,1/10/1987,1987,2300,0,7800,10100
West Okoboji Lake,January,1/24/1987,1987,46929,0,43920,90849
West Okoboji Lake,February,2/19/1988,1988,10830,0,4080,14910
West Okoboji Lake,February,2/22/1988,1988,0,0,0,0
West Okoboji Lake,January,1/25/1989,1989,62000,1800,79000,142800
West Okoboji Lake,January,1/27/1989,1989,10000,0,16000,26000
West Okoboji Lake,January,1/31/1989,1989,0,0,0,0
West Okoboji Lake,February,2/15/1989,1989,0,5265,0,5265
West Okoboji Lake,May,5/9/1989,1989,0,0,0,0
West Okoboji Lake,October,10/26/1989,1989,1700,0,0,1700
West Okoboji Lake,October,10/27/1989,1989,1340,0,0,1340
West Okoboji Lake,November,11/2/1989,1989,0,30,0,30
West Okoboji Lake,November,11/3/1989,1989,0,40,0,40
West Okoboji Lake,January,1/26/1990,1990,21705,450,13600,35755
West Okoboji Lake,February,2/1/1990,1990,15510,0,9920,25430
West Okoboji Lake,April,4/27/1990,1990,0,0,250,250
West Okoboji Lake,February,2/21/1991,1991,27600,0,18300,45900
West Okoboji Lake,May,5/13/1994,1994,200,0,1600,1800
West Okoboji Lake,May,5/18/1994,1994,450,200,2850,3500
West Okoboji Lake,May,5/19/1994,1994,700,100,5100,5900
West Okoboji Lake,February,2/6/1997,1997,0,0,0,0
West Okoboji Lake,February,2/12/1997,1997,1100,0,15700,16800
West Okoboji Lake,February,2/13/1997,1997,16100,0,29200,45300
West Okoboji Lake,February,2/14/1997,1997,6200,0,13500,19700
West Okoboji Lake,February,2/17/1997,1997,14300,0,42900,57200
West Okoboji Lake,February,2/20/1997,1997,0,0,0,0
West Okoboji Lake,February,2/24/1997,1997,0,0,0,0
West Okoboji Lake,February,2/25/1997,1997,8100,0,31500,39600
West Okoboji Lake,February,2/26/1997,1997,2500,0,17500,20000
West Okoboji Lake,March,3/16/1997,1997,10500,0,67300,77800
West Okoboji Lake,February,1/21/1998,1998,750,0,2550,3300
West Okoboji Lake,February,1/22/1998,1998,0,0,0,0
West Okoboji Lake,February,2/3/1998,1998,2700,0,14300,17000
West Okoboji Lake,February,2/9/1998,1998,0,0,0,0
West Okoboji Lake,February,2/9/1998,1998,0,0,0,0
West Okoboji Lake,February,2/10/1998,1998,1100,0,19700,20800
West Okoboji Lake,February,2/15/2002,2002,84800,3667,89701,178168
West Okoboji Lake,March,3/2/2009,2009,6800,2100,27200,36100
West Okoboji Lake,march,3/5/2009,2009,1500,100,300,1900
West Okoboji Lake,January,1/17/2011,2011,1800,0,600,2400
West Swan Lake,April,4/21/1992,1992,30,0,250,280
West Swan Lake,April,4/22/1992,1992,50,0,300,350
West Swan Lake,September,9/28/1992,1992,4100,0,50,4150
West Swan Lake,September,9/29/1992,1992,2975,0,675,3650
West Swan Lake,September,9/30/1992,1992,3000,0,425,3425
West Swan Lake,October,10/26/1992,1992,1700,0,300,2000
West Swan Lake,October,10/27/1992,1992,2700,0,500,3200
West Swan Lake,October,10/28/1992,1992,500,0,300,800
West Swan Lake,September,9/21/1993,1993,9700,0,275,9975
West Swan Lake,September,9/22/1993,1993,2750,0,750,3500
West Swan Lake,September,9/23/1993,1993,2200,0,50,2250
West Swan Lake,September,9/28/1993,1993,250,0,30,280
West Swan Lake,September,9/29/1993,1993,8600,0,200,8800
West Swan Lake,November,11/16/1993,1993,8500,0,1400,9900
West Swan Lake,October,10/5/1994,1994,3200,0,1300,4500
West Swan Lake,October,10/26/1994,1994,4900,0,1300,6200
West Swan Lake,September,9/26/1995,1995,450,0,4200,4650
West Swan Lake,September,9/27/1995,1995,13250,0,3200,16450
West Swan Lake,November,11/1/1995,1995,2630,0,9600,12230
West Swan Lake,October,10/21/1996,1996,3450,0,3420,6870
West Swan Lake,October,10/22/1996,1996,2100,0,175,2275
West Swan Lake,September,9/23/1997,1997,2250,0,6700,8950
West Swan Lake,September,9/24/1997,1997,1623,0,20840,22463
West Swan Lake,November,11/4/1997,1997,10950,0,130,11080
West Swan lake,October,10/20/1998,1998,9575,0,12200,21775
West Swan lake,November,11/5/1998,1998,4500,0,3700,8200
West Swan Lake,September,9/20/1999,1999,12100,0,3100,15200
West Swan Lake,October,10/18/1999,1999,7150,0,4600,11750
West Swan Lake,October,10/11/2000,2000,3635,0,5250,8885
West Swan Lake,October,10/12/2000,2000,12400,0,9400,21800
West Swan Lake,October,10/31/2000,2000,3300,0,12200,15500
West Swan Lake,October,10/4/2001,2001,168,0,308,476
West Swan Lake,october,10/30/2006,2006,1620,0,3900,5520
West Swan Lake,november,11/6/2006,2006,3480,0,11295,14775
West Swan Lake,november,11/7/2006,2006,3700,0,5685,9385
West Swan Lake,november,11/9/2006,2006,3140,0,6400,9540
West Swan Lake,September,9/29/2007,2007,6890,0,250,7140
West Swan Lake,September,9/30/2007,2007,350,0,940,1290
West Swan Lake,october,10/27/2007,2007,705,0,180,885
West Swan Lake,october,10/28/2007,2007,620,0,210,830
West Swan Lake,october,10/23/2008,2008,875,0,750,1625
West Swan Lake,october,10/24/2008,2008,0,0,0,0
West Swan Lake,October,10/6/2009,2009,180,0,31840,32020
West Swan Lake,September,9/21/2010,2010,15200,0,3175,18375
West Swan Lake,May,5/20/2013,2013,100,0,600,700
West Swan Lake,May,5/21/2013,2013,4500,0,500,5000
West Swan Lake,November,11/5/2013,2013,14200,0,3200,17400
West Swan Lake,September,9/5/2014,2014,11640,0,2010,13650
West Swan Lake,September,9/6/2014,2014,9530,0,800,10330
West Swan Lake,September,9/7/2014,2014,2670,0,2590,5260
West Swan Lake,September,9/20/2015,2015,5350,0,1190,6540
West Swan Lake,September,9/21/2015,2015,20720,0,915,21635
West Swan Lake,October,10/10/2015,2015,14665,0,3300,17965
West Swan Lake,October,10/11/2015,2015,935,0,3320,4255
West Swan Lake,September,9/18/2016,2016,15290,0,5700,20990
West Swan Lake,October,10/1/2016,2016,3400,0,4000,7400
West Swan Lake,October,10/2/2016,2016,13285,0,2053,15338
West Swan Lake,October,10/19/2016,2016,9160,0,510,9670
West Swan Lake,October,10/20/2016,2016,4900,0,475,5375
West Swan Lake,September,9/30/2017,2017,2500,0,800,3300
West Swan Lake,September,10/1/2017,2017,3900,0,900,4800
West Swan Lake,october,10/2/2017,2017,7500,0,1008,8508
North Twin Lake,,,1981,38325,400,22635,61360
Storm Lake,,,1981,22500,0,0,22500
North Twin Lake,,,1980,17320,1445,44225,62990
Storm Lake,,,1980,1125,0,5,1130
North Twin Lake,,,1985,110,140,2075,2325
North Twin Lake,,,1993,75,105,1142,1322
North Twin Lake,,,1996,300,20,900,1220
North Twin Lake,,,1999,2400,6000,21600,30000
North Twin Lake,,,2001,1000,4100,5000,10100
North Twin Lake,,,2002,500,800,5500,6800
North Twin Lake,,,2003,800,2800,600,4200
North Twin Lake,,,2004,0,0,1050,1050
Blue Lake,,,2004,120,0,1100,1220
Blue Lake,,,2005,36,0,16200,16236
Blue Lake,,,2006,0,0,14850,14850
North Twin Lake,,,2008,600,7000,18900,26500
Storm Lake,,,2010,27900,0,15660,43560
North Twin Lake,,,2011,95,4000,125,4220
Storm Lake,,,2011,14230,0,77230,91460
Storm Lake,,,2012,7846,0,57719,65565
Storm Lake,,,2013,625,0,16670,17295
Storm Lake,,,2014,15240,0,37460,52700
Storm Lake,,,2015,2495,0,40670,43165
Storm Lake,,,2016,2324,0,19700,22024
Blue Lake,,,2000,3000,0,2000,5000
Blue Lake,,,1999,2165,0,280,2445
